Year,Season,Team,G,MP,FG,FGA,FG%,3P,3PA,3P%,2P,2PA,2P%,PTS,Diff,3pt_attempt_pct,year2,season_team,avg_3pt_attempted_per_game,avg_2pt_att_per_game,avg_fg_per_game
2024,2023-24,Boston Celtics,82,19830,3601,7396,49%,1351,3482,39%,2250,3914,58%,9887,-432,47%,23-24,23-24 Boston Celtics,42.46341463,47.73170732,90.19512195
2024,2023-24,Dallas Mavericks,82,19705,3535,7352,48%,1197,3242,37%,2338,4110,57%,9664,-868,44%,23-24,23-24 Dallas Mavericks,39.53658537,50.12195122,89.65853659
2024,2023-24,Sacramento Kings,82,19855,3553,7455,48%,1178,3219,37%,2375,4236,56%,9558,-1017,43%,23-24,23-24 Sacramento Kings,39.25609756,51.65853659,90.91463415
2024,2023-24,Milwaukee Bucks,82,19805,3538,7258,49%,1163,3122,37%,2375,4136,57%,9756,-1014,43%,23-24,23-24 Milwaukee Bucks,38.07317073,50.43902439,88.51219512
2024,2023-24,Memphis Grizzlies,82,19780,3145,7230,44%,1071,3097,35%,2074,4133,50%,8677,-1036,43%,23-24,23-24 Memphis Grizzlies,37.76829268,50.40243902,88.17073171
2024,2023-24,Golden State Warriors,82,19830,3582,7515,48%,1211,3191,38%,2371,4324,55%,9657,-1133,42%,23-24,23-24 Golden State Warriors,38.91463415,52.73170732,91.64634146
2024,2023-24,Cleveland Cavaliers,82,19805,3425,7148,48%,1108,3016,37%,2317,4132,56%,9236,-1116,42%,23-24,23-24 Cleveland Cavaliers,36.7804878,50.3902439,87.17073171
2024,2023-24,Brooklyn Nets,82,19805,3334,7307,46%,1089,3010,36%,2245,4297,52%,9050,-1287,41%,23-24,23-24 Brooklyn Nets,36.70731707,52.40243902,89.1097561
2024,2023-24,Atlanta Hawks,82,19855,3529,7584,47%,1125,3092,36%,2404,4492,54%,9703,-1400,41%,23-24,23-24 Atlanta Hawks,37.70731707,54.7804878,92.48780488
2024,2023-24,Utah Jazz,82,19805,3443,7371,47%,1060,2993,35%,2383,4378,54%,9484,-1385,41%,23-24,23-24 Utah Jazz,36.5,53.3902439,89.8902439
2024,2023-24,New York Knicks,82,19730,3385,7272,47%,1083,2936,37%,2302,4336,53%,9249,-1400,40%,23-24,23-24 New York Knicks,35.80487805,52.87804878,88.68292683
2024,2023-24,San Antonio Spurs,82,19830,3438,7436,46%,1036,2983,35%,2402,4453,54%,9192,-1470,40%,23-24,23-24 San Antonio Spurs,36.37804878,54.30487805,90.68292683
2024,2023-24,Houston Rockets,82,19855,3425,7459,46%,1043,2964,35%,2382,4495,53%,9375,-1531,40%,23-24,23-24 Houston Rockets,36.14634146,54.81707317,90.96341463
2024,2023-24,Miami Heat,82,19755,3266,7022,47%,1022,2765,37%,2244,4257,53%,9032,-1492,39%,23-24,23-24 Miami Heat,33.7195122,51.91463415,85.63414634
2024,2023-24,Charlotte Hornets,82,19730,3281,7133,46%,989,2788,36%,2292,4345,53%,8740,-1557,39%,23-24,23-24 Charlotte Hornets,34,52.98780488,86.98780488
2024,2023-24,Washington Wizards,82,19730,3523,7493,47%,1015,2915,35%,2508,4578,55%,9327,-1663,39%,23-24,23-24 Washington Wizards,35.54878049,55.82926829,91.37804878
2024,2023-24,Minnesota Timberwolves,82,19805,3383,6974,49%,1037,2681,39%,2346,4293,55%,9264,-1612,38%,23-24,23-24 Minnesota Timberwolves,32.69512195,52.35365854,85.04878049
2024,2023-24,Oklahoma City Thunder,82,19805,3653,7324,50%,1090,2805,39%,2563,4519,57%,9847,-1714,38%,23-24,23-24 Oklahoma City Thunder,34.20731707,55.1097561,89.31707317
2024,2023-24,Los Angeles Clippers,82,19705,3473,7108,49%,1036,2719,38%,2437,4389,56%,9481,-1670,38%,23-24,23-24 Los Angeles Clippers,33.15853659,53.52439024,86.68292683
2024,2023-24,Indiana Pacers,82,19705,3855,7599,51%,1082,2891,37%,2773,4708,59%,10110,-1817,38%,23-24,23-24 Indiana Pacers,35.25609756,57.41463415,92.67073171
2024,2023-24,Phoenix Suns,82,19780,3482,7063,49%,1020,2671,38%,2462,4392,56%,9532,-1721,38%,23-24,23-24 Phoenix Suns,32.57317073,53.56097561,86.13414634
2024,2023-24,New Orleans Pelicans,82,19705,3484,7165,49%,1023,2673,38%,2461,4492,55%,9436,-1819,37%,23-24,23-24 New Orleans Pelicans,32.59756098,54.7804878,87.37804878
2024,2023-24,Philadelphia 76ers,82,19780,3404,7331,46%,992,2733,36%,2412,4598,53%,9397,-1865,37%,23-24,23-24 Philadelphia 76ers,33.32926829,56.07317073,89.40243902
2024,2023-24,Portland Trail Blazers,82,19880,3227,7356,44%,939,2723,35%,2288,4633,49%,8722,-1910,37%,23-24,23-24 Portland Trail Blazers,33.20731707,56.5,89.70731707
2024,2023-24,Orlando Magic,82,19780,3318,6964,48%,903,2568,35%,2415,4396,55%,9058,-1828,37%,23-24,23-24 Orlando Magic,31.31707317,53.6097561,84.92682927
2024,2023-24,Toronto Raptors,82,19805,3466,7356,47%,942,2712,35%,2524,4644,54%,9213,-1932,37%,23-24,23-24 Toronto Raptors,33.07317073,56.63414634,89.70731707
2024,2023-24,Detroit Pistons,82,19755,3353,7236,46%,906,2602,35%,2447,4634,53%,9010,-2032,36%,23-24,23-24 Detroit Pistons,31.73170732,56.51219512,88.24390244
2024,2023-24,Los Angeles Lakers,82,19855,3580,7177,50%,969,2572,38%,2611,4605,57%,9679,-2033,36%,23-24,23-24 Los Angeles Lakers,31.36585366,56.15853659,87.52439024
2024,2023-24,Chicago Bulls,82,19980,3448,7339,47%,941,2630,36%,2507,4709,53%,9206,-2079,36%,23-24,23-24 Chicago Bulls,32.07317073,57.42682927,89.5
2024,2023-24,Denver Nuggets,82,19705,3610,7279,50%,958,2560,37%,2652,4719,56%,9418,-2159,35%,23-24,23-24 Denver Nuggets,31.2195122,57.54878049,88.76829268
2023,2022-23,Sacramento Kings,82,19830,3573,7232,49%,1128,3060,37%,2445,4172,59%,9898,-1112,42%,22-23,22-23 Sacramento Kings,37.31707317,50.87804878,88.19512195
2023,2022-23,Golden State Warriors,82,19830,3538,7393,48%,1363,3540,39%,2175,3853,56%,9753,-313,48%,22-23,22-23 Golden State Warriors,43.17073171,46.98780488,90.15853659
2023,2022-23,Atlanta Hawks,82,19855,3658,7574,48%,882,2505,35%,2776,5069,55%,9711,-2564,33%,22-23,22-23 Atlanta Hawks,30.54878049,61.81707317,92.36585366
2023,2022-23,Boston Celtics,82,19980,3460,7278,48%,1315,3492,38%,2145,3786,57%,9671,-294,48%,22-23,22-23 Boston Celtics,42.58536585,46.17073171,88.75609756
2023,2022-23,Oklahoma City Thunder,82,19855,3533,7590,47%,995,2797,36%,2538,4793,53%,9633,-1996,37%,22-23,22-23 Oklahoma City Thunder,34.1097561,58.45121951,92.56097561
2023,2022-23,Los Angeles Lakers,82,19880,3516,7298,48%,885,2558,35%,2631,4740,56%,9608,-2182,35%,22-23,22-23 Los Angeles Lakers,31.19512195,57.80487805,89
2023,2022-23,Utah Jazz,82,19805,3485,7365,47%,1094,3099,35%,2391,4266,56%,9600,-1167,42%,22-23,22-23 Utah Jazz,37.79268293,52.02439024,89.81707317
2023,2022-23,Milwaukee Bucks,82,19830,3504,7411,47%,1217,3306,37%,2287,4105,56%,9589,-799,45%,22-23,22-23 Milwaukee Bucks,40.31707317,50.06097561,90.37804878
2023,2022-23,Memphis Grizzlies,82,19780,3585,7551,48%,985,2807,35%,2600,4744,55%,9587,-1937,37%,22-23,22-23 Memphis Grizzlies,34.23170732,57.85365854,92.08536585
2023,2022-23,Indiana Pacers,82,19755,3444,7345,47%,1112,3030,37%,2332,4315,54%,9535,-1285,41%,22-23,22-23 Indiana Pacers,36.95121951,52.62195122,89.57317073
2023,2022-23,New York Knicks,82,19955,3444,7328,47%,1037,2930,35%,2407,4398,55%,9514,-1468,40%,22-23,22-23 New York Knicks,35.73170732,53.63414634,89.36585366
2023,2022-23,Denver Nuggets,82,19755,3574,7088,50%,969,2559,38%,2605,4529,58%,9495,-1970,36%,22-23,22-23 Denver Nuggets,31.20731707,55.23170732,86.43902439
2023,2022-23,Minnesota Timberwolves,82,19830,3515,7167,49%,997,2731,37%,2518,4436,57%,9494,-1705,38%,22-23,22-23 Minnesota Timberwolves,33.30487805,54.09756098,87.40243902
2023,2022-23,Philadelphia 76ers,82,19880,3347,6870,49%,1035,2675,39%,2312,4195,55%,9448,-1520,39%,22-23,22-23 Philadelphia 76ers,32.62195122,51.15853659,83.7804878
2023,2022-23,New Orleans Pelicans,82,19855,3447,7180,48%,899,2468,36%,2548,4712,54%,9378,-2244,34%,22-23,22-23 New Orleans Pelicans,30.09756098,57.46341463,87.56097561
2023,2022-23,Dallas Mavericks,82,19930,3283,6909,48%,1246,3362,37%,2037,3547,57%,9366,-185,49%,22-23,22-23 Dallas Mavericks,41,43.25609756,84.25609756
2023,2022-23,Phoenix Suns,82,19780,3453,7388,47%,1001,2674,37%,2452,4714,52%,9319,-2040,36%,22-23,22-23 Phoenix Suns,32.6097561,57.48780488,90.09756098
2023,2022-23,Los Angeles Clippers,82,19830,3370,7059,48%,1041,2735,38%,2329,4324,54%,9314,-1589,39%,22-23,22-23 Los Angeles Clippers,33.35365854,52.73170732,86.08536585
2023,2022-23,Portland Trail Blazers,82,19730,3317,7001,47%,1056,2893,37%,2261,4108,55%,9299,-1215,41%,22-23,22-23 Portland Trail Blazers,35.2804878,50.09756098,85.37804878
2023,2022-23,Brooklyn Nets,82,19730,3399,6978,49%,1048,2771,38%,2351,4207,56%,9295,-1436,40%,22-23,22-23 Brooklyn Nets,33.79268293,51.30487805,85.09756098
2023,2022-23,Washington Wizards,82,19755,3456,7127,49%,925,2601,36%,2531,4526,56%,9279,-1925,36%,22-23,22-23 Washington Wizards,31.7195122,55.19512195,86.91463415
2023,2022-23,Chicago Bulls,82,19905,3488,7116,49%,854,2367,36%,2634,4749,56%,9276,-2382,33%,22-23,22-23 Chicago Bulls,28.86585366,57.91463415,86.7804878
2023,2022-23,San Antonio Spurs,82,19855,3533,7593,47%,911,2640,35%,2622,4953,53%,9269,-2313,35%,22-23,22-23 San Antonio Spurs,32.19512195,60.40243902,92.59756098
2023,2022-23,Toronto Raptors,82,19805,3434,7489,46%,880,2626,34%,2554,4863,53%,9254,-2237,35%,22-23,22-23 Toronto Raptors,32.02439024,59.30487805,91.32926829
2023,2022-23,Cleveland Cavaliers,82,19880,3408,6984,49%,950,2589,37%,2458,4395,56%,9205,-1806,37%,22-23,22-23 Cleveland Cavaliers,31.57317073,53.59756098,85.17073171
2023,2022-23,Orlando Magic,82,19780,3323,7074,47%,883,2551,35%,2440,4523,54%,9136,-1972,36%,22-23,22-23 Orlando Magic,31.1097561,55.15853659,86.26829268
2023,2022-23,Charlotte Hornets,82,19830,3385,7413,46%,881,2669,33%,2504,4744,53%,9098,-2075,36%,22-23,22-23 Charlotte Hornets,32.54878049,57.85365854,90.40243902
2023,2022-23,Houston Rockets,82,19755,3329,7287,46%,856,2619,33%,2473,4668,53%,9081,-2049,36%,22-23,22-23 Houston Rockets,31.93902439,56.92682927,88.86585366
2023,2022-23,Detroit Pistons,82,19805,3244,7140,45%,934,2659,35%,2310,4481,52%,9045,-1822,37%,22-23,22-23 Detroit Pistons,32.42682927,54.64634146,87.07317073
2023,2022-23,Miami Heat,82,19805,3215,6991,46%,980,2852,34%,2235,4139,54%,8977,-1287,41%,22-23,22-23 Miami Heat,34.7804878,50.47560976,85.25609756
2022,2021-22,Minnesota Timberwolves,82,19780,3411,7458,46%,1211,3386,36%,2200,4072,54%,9507,-686,45%,21-22,21-22 Minnesota Timberwolves,41.29268293,49.65853659,90.95121951
2022,2021-22,Memphis Grizzlies,82,19780,3571,7739,46%,945,2679,35%,2626,5060,52%,9480,-2381,35%,21-22,21-22 Memphis Grizzlies,32.67073171,61.70731707,94.37804878
2022,2021-22,Milwaukee Bucks,82,19755,3429,7331,47%,1153,3151,37%,2276,4180,54%,9470,-1029,43%,21-22,21-22 Milwaukee Bucks,38.42682927,50.97560976,89.40243902
2022,2021-22,Charlotte Hornets,82,19880,3508,7497,47%,1143,3130,37%,2365,4367,54%,9457,-1237,42%,21-22,21-22 Charlotte Hornets,38.17073171,53.25609756,91.42682927
2022,2021-22,Phoenix Suns,82,19730,3581,7389,49%,951,2616,36%,2630,4773,55%,9416,-2157,35%,21-22,21-22 Phoenix Suns,31.90243902,58.20731707,90.1097561
2022,2021-22,Atlanta Hawks,82,19705,3401,7241,47%,1056,2821,37%,2345,4420,53%,9343,-1599,39%,21-22,21-22 Atlanta Hawks,34.40243902,53.90243902,88.30487805
2022,2021-22,Utah Jazz,82,19730,3327,7067,47%,1192,3308,36%,2135,3759,57%,9316,-451,47%,21-22,21-22 Utah Jazz,40.34146341,45.84146341,86.18292683
2022,2021-22,San Antonio Spurs,82,19805,3546,7601,47%,925,2626,35%,2621,4975,53%,9279,-2349,35%,21-22,21-22 San Antonio Spurs,32.02439024,60.67073171,92.69512195
2022,2021-22,Brooklyn Nets,82,19755,3442,7251,48%,940,2602,36%,2502,4649,54%,9258,-2047,36%,21-22,21-22 Brooklyn Nets,31.73170732,56.69512195,88.42682927
2022,2021-22,Denver Nuggets,82,19805,3416,7079,48%,1039,2944,35%,2377,4135,58%,9243,-1191,42%,21-22,21-22 Denver Nuggets,35.90243902,50.42682927,86.32926829
2022,2021-22,Los Angeles Lakers,82,19980,3415,7279,47%,982,2826,35%,2433,4453,55%,9192,-1627,39%,21-22,21-22 Los Angeles Lakers,34.46341463,54.30487805,88.76829268
2022,2021-22,Boston Celtics,82,19905,3341,7167,47%,1085,3044,36%,2256,4123,55%,9164,-1079,42%,21-22,21-22 Boston Celtics,37.12195122,50.2804878,87.40243902
2022,2021-22,Chicago Bulls,82,19730,3422,7127,48%,872,2364,37%,2550,4763,54%,9152,-2399,33%,21-22,21-22 Chicago Bulls,28.82926829,58.08536585,86.91463415
2022,2021-22,Indiana Pacers,82,19880,3398,7338,46%,997,2899,34%,2401,4439,54%,9140,-1540,40%,21-22,21-22 Indiana Pacers,35.35365854,54.13414634,89.48780488
2022,2021-22,Golden State Warriors,82,19730,3323,7087,47%,1176,3231,36%,2147,3856,56%,9102,-625,46%,21-22,21-22 Golden State Warriors,39.40243902,47.02439024,86.42682927
2022,2021-22,Sacramento Kings,82,19805,3321,7223,46%,937,2722,34%,2384,4501,53%,9045,-1779,38%,21-22,21-22 Sacramento Kings,33.19512195,54.8902439,88.08536585
2022,2021-22,Miami Heat,82,19855,3246,6954,47%,1114,2936,38%,2132,4018,53%,9022,-1082,42%,21-22,21-22 Miami Heat,35.80487805,49,84.80487805
2022,2021-22,Philadelphia 76ers,82,19805,3230,6932,47%,950,2608,36%,2280,4324,53%,9015,-1716,38%,21-22,21-22 Philadelphia 76ers,31.80487805,52.73170732,84.53658537
2022,2021-22,Houston Rockets,82,19755,3229,7083,46%,1105,3170,35%,2124,3913,54%,8997,-743,45%,21-22,21-22 Houston Rockets,38.65853659,47.7195122,86.37804878
2022,2021-22,Toronto Raptors,82,19855,3332,7489,45%,979,2808,35%,2353,4681,50%,8970,-1873,37%,21-22,21-22 Toronto Raptors,34.24390244,57.08536585,91.32926829
2022,2021-22,New Orleans Pelicans,82,19755,3294,7212,46%,873,2629,33%,2421,4583,53%,8962,-1954,36%,21-22,21-22 New Orleans Pelicans,32.06097561,55.8902439,87.95121951
2022,2021-22,Washington Wizards,82,19830,3327,7056,47%,860,2512,34%,2467,4544,54%,8907,-2032,36%,21-22,21-22 Washington Wizards,30.63414634,55.41463415,86.04878049
2022,2021-22,Los Angeles Clippers,82,19780,3285,7170,46%,1047,2802,37%,2238,4368,51%,8890,-1566,39%,21-22,21-22 Los Angeles Clippers,34.17073171,53.26829268,87.43902439
2022,2021-22,Dallas Mavericks,82,19755,3222,6982,46%,1073,3063,35%,2149,3919,55%,8858,-856,44%,21-22,21-22 Dallas Mavericks,37.35365854,47.79268293,85.14634146
2022,2021-22,Cleveland Cavaliers,82,19730,3255,6940,47%,953,2686,36%,2302,4254,54%,8839,-1568,39%,21-22,21-22 Cleveland Cavaliers,32.75609756,51.87804878,84.63414634
2022,2021-22,New York Knicks,82,19780,3088,7069,44%,1082,3029,36%,2006,4040,50%,8731,-1011,43%,21-22,21-22 New York Knicks,36.93902439,49.26829268,86.20731707
2022,2021-22,Portland Trail Blazers,82,19730,3161,7144,44%,1043,3017,35%,2118,4127,51%,8711,-1110,42%,21-22,21-22 Portland Trail Blazers,36.79268293,50.32926829,87.12195122
2022,2021-22,Detroit Pistons,82,19780,3129,7267,43%,925,2838,33%,2204,4429,50%,8596,-1591,39%,21-22,21-22 Detroit Pistons,34.6097561,54.01219512,88.62195122
2022,2021-22,Orlando Magic,82,19780,3139,7240,43%,999,3022,33%,2140,4218,51%,8547,-1196,42%,21-22,21-22 Orlando Magic,36.85365854,51.43902439,88.29268293
2022,2021-22,Oklahoma City Thunder,82,19805,3141,7310,43%,991,3066,32%,2150,4244,51%,8506,-1178,42%,21-22,21-22 Oklahoma City Thunder,37.3902439,51.75609756,89.14634146
2021,2020-21,Milwaukee Bucks,72,17330,3221,6610,49%,1038,2669,39%,2183,3941,55%,8649,-1272,40%,20-21,20-21 Milwaukee Bucks,37.06944444,54.73611111,91.80555556
2021,2020-21,Brooklyn Nets,72,17405,3106,6289,49%,1020,2600,39%,2086,3689,57%,8537,-1089,41%,20-21,20-21 Brooklyn Nets,36.11111111,51.23611111,87.34722222
2021,2020-21,Washington Wizards,72,17405,3108,6547,48%,733,2088,35%,2375,4459,53%,8398,-2371,32%,20-21,20-21 Washington Wizards,29,61.93055556,90.93055556
2021,2020-21,Utah Jazz,72,17355,2971,6344,47%,1205,3098,39%,1766,3246,54%,8382,-148,49%,20-21,20-21 Utah Jazz,43.02777778,45.08333333,88.11111111
2021,2020-21,Portland Trail Blazers,72,17305,2973,6558,45%,1132,2939,39%,1841,3619,51%,8360,-680,45%,20-21,20-21 Portland Trail Blazers,40.81944444,50.26388889,91.08333333
2021,2020-21,Indiana Pacers,72,17455,3115,6567,47%,889,2445,36%,2226,4122,54%,8302,-1677,37%,20-21,20-21 Indiana Pacers,33.95833333,57.25,91.20833333
2021,2020-21,Phoenix Suns,72,17480,3118,6357,49%,940,2490,38%,2178,3867,56%,8300,-1377,39%,20-21,20-21 Phoenix Suns,34.58333333,53.70833333,88.29166667
2021,2020-21,Denver Nuggets,72,17480,3114,6422,49%,927,2462,38%,2187,3960,55%,8284,-1498,38%,20-21,20-21 Denver Nuggets,34.19444444,55,89.19444444
2021,2020-21,New Orleans Pelicans,72,17430,3060,6412,48%,762,2190,35%,2298,4222,54%,8251,-2032,34%,20-21,20-21 New Orleans Pelicans,30.41666667,58.63888889,89.05555556
2021,2020-21,Los Angeles Clippers,72,17280,3009,6242,48%,1027,2498,41%,1982,3744,53%,8209,-1246,40%,20-21,20-21 Los Angeles Clippers,34.69444444,52,86.69444444
2021,2020-21,Sacramento Kings,72,17305,3067,6382,48%,874,2400,36%,2193,3982,55%,8189,-1582,38%,20-21,20-21 Sacramento Kings,33.33333333,55.30555556,88.63888889
2021,2020-21,Golden State Warriors,72,17305,2973,6347,47%,1048,2789,38%,1925,3558,54%,8187,-769,44%,20-21,20-21 Golden State Warriors,38.73611111,49.41666667,88.15277778
2021,2020-21,Atlanta Hawks,72,17405,2937,6281,47%,895,2402,37%,2042,3879,53%,8186,-1477,38%,20-21,20-21 Atlanta Hawks,33.36111111,53.875,87.23611111
2021,2020-21,Philadelphia 76ers,72,17430,2981,6257,48%,811,2169,37%,2170,4088,53%,8182,-1919,35%,20-21,20-21 Philadelphia 76ers,30.125,56.77777778,86.90277778
2021,2020-21,Memphis Grizzlies,72,17405,3085,6608,47%,803,2258,36%,2282,4350,53%,8157,-2092,34%,20-21,20-21 Memphis Grizzlies,31.36111111,60.41666667,91.77777778
2021,2020-21,Boston Celtics,72,17380,2985,6401,47%,979,2618,37%,2006,3783,53%,8109,-1165,41%,20-21,20-21 Boston Celtics,36.36111111,52.54166667,88.90277778
2021,2020-21,Dallas Mavericks,72,17305,2958,6287,47%,994,2744,36%,1964,3543,55%,8096,-799,44%,20-21,20-21 Dallas Mavericks,38.11111111,49.20833333,87.31944444
2021,2020-21,Minnesota Timberwolves,72,17405,2932,6546,45%,944,2706,35%,1988,3840,52%,8073,-1134,41%,20-21,20-21 Minnesota Timberwolves,37.58333333,53.33333333,90.91666667
2021,2020-21,Toronto Raptors,72,17305,2859,6383,45%,1041,2831,37%,1818,3552,51%,8011,-721,44%,20-21,20-21 Toronto Raptors,39.31944444,49.33333333,88.65277778
2021,2020-21,San Antonio Spurs,72,17480,3014,6518,46%,716,2046,35%,2298,4472,51%,7998,-2426,31%,20-21,20-21 San Antonio Spurs,28.41666667,62.11111111,90.52777778
2021,2020-21,Chicago Bulls,72,17380,3035,6380,48%,904,2446,37%,2131,3934,54%,7969,-1488,38%,20-21,20-21 Chicago Bulls,33.97222222,54.63888889,88.61111111
2021,2020-21,Los Angeles Lakers,72,17455,2925,6197,47%,796,2248,35%,2129,3949,54%,7887,-1701,36%,20-21,20-21 Los Angeles Lakers,31.22222222,54.84722222,86.06944444
2021,2020-21,Charlotte Hornets,72,17355,2875,6324,46%,985,2666,37%,1890,3658,52%,7881,-992,42%,20-21,20-21 Charlotte Hornets,37.02777778,50.80555556,87.83333333
2021,2020-21,Houston Rockets,72,17305,2826,6372,44%,992,2923,34%,1834,3449,53%,7833,-526,46%,20-21,20-21 Houston Rockets,40.59722222,47.90277778,88.5
2021,2020-21,Miami Heat,72,17380,2824,6029,47%,932,2606,36%,1892,3423,55%,7781,-817,43%,20-21,20-21 Miami Heat,36.19444444,47.54166667,83.73611111
2021,2020-21,New York Knicks,72,17430,2839,6225,46%,847,2163,39%,1992,4062,49%,7706,-1899,35%,20-21,20-21 New York Knicks,30.04166667,56.41666667,86.45833333
2021,2020-21,Detroit Pistons,72,17430,2783,6162,45%,832,2370,35%,1951,3792,52%,7676,-1422,38%,20-21,20-21 Detroit Pistons,32.91666667,52.66666667,85.58333333
2021,2020-21,Oklahoma City Thunder,72,17355,2795,6338,44%,857,2529,34%,1938,3809,51%,7560,-1280,40%,20-21,20-21 Oklahoma City Thunder,35.125,52.90277778,88.02777778
2021,2020-21,Orlando Magic,72,17330,2754,6423,43%,784,2288,34%,1970,4135,48%,7488,-1847,36%,20-21,20-21 Orlando Magic,31.77777778,57.43055556,89.20833333
2021,2020-21,Cleveland Cavaliers,72,17430,2778,6175,45%,720,2141,34%,2058,4034,51%,7476,-1893,35%,20-21,20-21 Cleveland Cavaliers,29.73611111,56.02777778,85.76388889
2020,2019-20,Dallas Mavericks,75,18175,3124,6772,46%,1136,3095,37%,1988,3677,54%,8776,-582,46%,19-20,19-20 Dallas Mavericks,41.26666667,49.02666667,90.29333333
2020,2019-20,Milwaukee Bucks,73,17595,3160,6638,48%,1007,2840,36%,2153,3798,57%,8663,-958,43%,19-20,19-20 Milwaukee Bucks,38.90410959,52.02739726,90.93150685
2020,2019-20,Portland Trail Blazers,74,17835,3122,6749,46%,952,2525,38%,2170,4224,51%,8508,-1699,37%,19-20,19-20 Portland Trail Blazers,34.12162162,57.08108108,91.2027027
2020,2019-20,Houston Rockets,72,17380,2936,6512,45%,1126,3261,35%,1810,3251,56%,8482,10,50%,19-20,19-20 Houston Rockets,45.29166667,45.15277778,90.44444444
2020,2019-20,Los Angeles Clippers,72,17380,2992,6425,47%,895,2410,37%,2097,4015,52%,8377,-1605,38%,19-20,19-20 Los Angeles Clippers,33.47222222,55.76388889,89.23611111
2020,2019-20,New Orleans Pelicans,72,17430,3065,6598,47%,982,2656,37%,2083,3942,53%,8341,-1286,40%,19-20,19-20 New Orleans Pelicans,36.88888889,54.75,91.63888889
2020,2019-20,Phoenix Suns,73,17595,3006,6429,47%,831,2320,36%,2175,4109,53%,8294,-1789,36%,19-20,19-20 Phoenix Suns,31.78082192,56.28767123,88.06849315
2020,2019-20,Washington Wizards,72,17355,2990,6544,46%,864,2345,37%,2126,4199,51%,8238,-1854,36%,19-20,19-20 Washington Wizards,32.56944444,58.31944444,90.88888889
2020,2019-20,Memphis Grizzlies,73,17570,3106,6634,47%,798,2297,35%,2308,4337,53%,8222,-2040,35%,19-20,19-20 Memphis Grizzlies,31.46575342,59.4109589,90.87671233
2020,2019-20,Boston Celtics,72,17430,2971,6448,46%,905,2487,36%,2066,3961,52%,8183,-1474,39%,19-20,19-20 Boston Celtics,34.54166667,55.01388889,89.55555556
2020,2019-20,Miami Heat,73,17745,2880,6160,47%,979,2584,38%,1901,3576,53%,8179,-992,42%,19-20,19-20 Miami Heat,35.39726027,48.98630137,84.38356164
2020,2019-20,Denver Nuggets,73,17745,3069,6488,47%,801,2234,36%,2268,4254,53%,8124,-2020,34%,19-20,19-20 Denver Nuggets,30.60273973,58.2739726,88.87671233
2020,2019-20,Toronto Raptors,72,17380,2897,6331,46%,995,2663,37%,1902,3668,52%,8118,-1005,42%,19-20,19-20 Toronto Raptors,36.98611111,50.94444444,87.93055556
2020,2019-20,San Antonio Spurs,71,17215,2995,6350,47%,760,2021,38%,2235,4329,52%,8098,-2308,32%,19-20,19-20 San Antonio Spurs,28.46478873,60.97183099,89.43661972
2020,2019-20,Philadelphia 76ers,73,17595,3000,6417,47%,848,2307,37%,2152,4110,52%,8084,-1803,36%,19-20,19-20 Philadelphia 76ers,31.60273973,56.30136986,87.90410959
2020,2019-20,Los Angeles Lakers,71,17090,3006,6269,48%,782,2242,35%,2224,4027,55%,8054,-1785,36%,19-20,19-20 Los Angeles Lakers,31.57746479,56.71830986,88.29577465
2020,2019-20,Brooklyn Nets,72,17480,2908,6498,45%,941,2746,34%,1967,3752,52%,8048,-1006,42%,19-20,19-20 Brooklyn Nets,38.13888889,52.11111111,90.25
2020,2019-20,Utah Jazz,72,17355,2886,6130,47%,963,2537,38%,1923,3593,54%,8013,-1056,41%,19-20,19-20 Utah Jazz,35.23611111,49.90277778,85.13888889
2020,2019-20,Indiana Pacers,73,17620,3075,6457,48%,743,2046,36%,2332,4411,53%,7989,-2365,32%,19-20,19-20 Indiana Pacers,28.02739726,60.42465753,88.45205479
2020,2019-20,Oklahoma City Thunder,72,17430,2879,6156,47%,770,2171,36%,2109,3985,53%,7950,-1814,35%,19-20,19-20 Oklahoma City Thunder,30.15277778,55.34722222,85.5
2020,2019-20,Sacramento Kings,72,17455,2943,6364,46%,914,2511,36%,2029,3853,53%,7927,-1342,39%,19-20,19-20 Sacramento Kings,34.875,53.51388889,88.38888889
2020,2019-20,Orlando Magic,73,17570,2871,6468,44%,807,2354,34%,2064,4114,50%,7831,-1760,36%,19-20,19-20 Orlando Magic,32.24657534,56.35616438,88.60273973
2020,2019-20,Atlanta Hawks,67,16280,2723,6067,45%,805,2416,33%,1918,3651,53%,7488,-1235,40%,19-20,19-20 Atlanta Hawks,36.05970149,54.49253731,90.55223881
2020,2019-20,Minnesota Timberwolves,64,15560,2586,5865,44%,853,2540,34%,1733,3325,52%,7248,-785,43%,19-20,19-20 Minnesota Timberwolves,39.6875,51.953125,91.640625
2020,2019-20,Detroit Pistons,66,15965,2595,5658,46%,791,2157,37%,1804,3501,52%,7078,-1344,38%,19-20,19-20 Detroit Pistons,32.68181818,53.04545455,85.72727273
2020,2019-20,New York Knicks,66,15965,2638,5896,45%,631,1872,34%,2007,4024,50%,6983,-2152,32%,19-20,19-20 New York Knicks,28.36363636,60.96969697,89.33333333
2020,2019-20,Cleveland Cavaliers,65,15725,2619,5715,46%,727,2070,35%,1892,3645,52%,6948,-1575,36%,19-20,19-20 Cleveland Cavaliers,31.84615385,56.07692308,87.92307692
2020,2019-20,Chicago Bulls,65,15675,2573,5762,45%,793,2282,35%,1780,3480,51%,6945,-1198,40%,19-20,19-20 Chicago Bulls,35.10769231,53.53846154,88.64615385
2020,2019-20,Golden State Warriors,65,15725,2510,5730,44%,678,2032,33%,1832,3698,50%,6912,-1666,35%,19-20,19-20 Golden State Warriors,31.26153846,56.89230769,88.15384615
2020,2019-20,Charlotte Hornets,65,15750,2425,5586,43%,785,2231,35%,1640,3355,49%,6687,-1124,40%,19-20,19-20 Charlotte Hornets,34.32307692,51.61538462,85.93846154
2019,2018-19,Milwaukee Bucks,82,19780,3555,7471,48%,1105,3134,35%,2450,4337,57%,9686,-1203,42%,18-19,18-19 Milwaukee Bucks,38.2195122,52.8902439,91.1097561
2019,2018-19,Golden State Warriors,82,19805,3612,7361,49%,1087,2824,39%,2525,4537,56%,9650,-1713,38%,18-19,18-19 Golden State Warriors,34.43902439,55.32926829,89.76829268
2019,2018-19,New Orleans Pelicans,82,19755,3581,7563,47%,842,2449,34%,2739,5114,54%,9466,-2665,32%,18-19,18-19 New Orleans Pelicans,29.86585366,62.36585366,92.23170732
2019,2018-19,Philadelphia 76ers,82,19805,3407,7233,47%,889,2474,36%,2518,4759,53%,9445,-2285,34%,18-19,18-19 Philadelphia 76ers,30.17073171,58.03658537,88.20731707
2019,2018-19,Los Angeles Clippers,82,19830,3384,7178,47%,821,2118,39%,2563,5060,51%,9442,-2942,30%,18-19,18-19 Los Angeles Clippers,25.82926829,61.70731707,87.53658537
2019,2018-19,Portland Trail Blazers,82,19855,3470,7427,47%,904,2520,36%,2566,4907,52%,9402,-2387,34%,18-19,18-19 Portland Trail Blazers,30.73170732,59.84146341,90.57317073
2019,2018-19,Oklahoma City Thunder,82,19855,3497,7706,45%,932,2677,35%,2565,5029,51%,9387,-2352,35%,18-19,18-19 Oklahoma City Thunder,32.64634146,61.32926829,93.97560976
2019,2018-19,Toronto Raptors,82,19880,3460,7305,47%,1015,2771,37%,2445,4534,54%,9384,-1763,38%,18-19,18-19 Toronto Raptors,33.79268293,55.29268293,89.08536585
2019,2018-19,Sacramento Kings,82,19730,3541,7637,46%,927,2455,38%,2614,5182,50%,9363,-2727,32%,18-19,18-19 Sacramento Kings,29.93902439,63.19512195,93.13414634
2019,2018-19,Washington Wizards,82,19930,3456,7387,47%,930,2731,34%,2526,4656,54%,9350,-1925,37%,18-19,18-19 Washington Wizards,33.30487805,56.7804878,90.08536585
2019,2018-19,Houston Rockets,82,19830,3218,7163,45%,1323,3721,36%,1895,3442,55%,9341,279,52%,18-19,18-19 Houston Rockets,45.37804878,41.97560976,87.35365854
2019,2018-19,Atlanta Hawks,82,19855,3392,7524,45%,1067,3034,35%,2325,4490,52%,9294,-1456,40%,18-19,18-19 Atlanta Hawks,37,54.75609756,91.75609756
2019,2018-19,Minnesota Timberwolves,82,19830,3413,7483,46%,827,2357,35%,2586,5126,50%,9223,-2769,31%,18-19,18-19 Minnesota Timberwolves,28.74390244,62.51219512,91.25609756
2019,2018-19,Boston Celtics,82,19780,3451,7423,47%,1032,2829,37%,2419,4594,53%,9216,-1765,38%,18-19,18-19 Boston Celtics,34.5,56.02439024,90.52439024
2019,2018-19,Brooklyn Nets,82,19980,3301,7358,45%,1047,2965,35%,2254,4393,51%,9204,-1428,40%,18-19,18-19 Brooklyn Nets,36.15853659,53.57317073,89.73170732
2019,2018-19,Los Angeles Lakers,82,19780,3491,7425,47%,847,2541,33%,2644,4884,54%,9165,-2343,34%,18-19,18-19 Los Angeles Lakers,30.98780488,59.56097561,90.54878049
2019,2018-19,Utah Jazz,82,19755,3314,7082,47%,993,2789,36%,2321,4293,54%,9161,-1504,39%,18-19,18-19 Utah Jazz,34.01219512,52.35365854,86.36585366
2019,2018-19,San Antonio Spurs,82,19805,3468,7248,48%,812,2071,39%,2656,5177,51%,9156,-3106,29%,18-19,18-19 San Antonio Spurs,25.25609756,63.13414634,88.3902439
2019,2018-19,Charlotte Hornets,82,19830,3297,7362,45%,977,2783,35%,2320,4579,51%,9081,-1796,38%,18-19,18-19 Charlotte Hornets,33.93902439,55.84146341,89.7804878
2019,2018-19,Denver Nuggets,82,19730,3439,7384,47%,903,2571,35%,2536,4813,53%,9075,-2242,35%,18-19,18-19 Denver Nuggets,31.35365854,58.69512195,90.04878049
2019,2018-19,Dallas Mavericks,82,19780,3182,7122,45%,1022,3002,34%,2160,4120,52%,8927,-1118,42%,18-19,18-19 Dallas Mavericks,36.6097561,50.24390244,86.85365854
2019,2018-19,Indiana Pacers,82,19705,3390,7135,48%,779,2081,37%,2611,5054,52%,8857,-2973,29%,18-19,18-19 Indiana Pacers,25.37804878,61.63414634,87.01219512
2019,2018-19,Phoenix Suns,82,19880,3289,7164,46%,790,2400,33%,2499,4764,53%,8815,-2364,34%,18-19,18-19 Phoenix Suns,29.26829268,58.09756098,87.36585366
2019,2018-19,Orlando Magic,82,19780,3316,7307,45%,937,2633,36%,2379,4674,51%,8800,-2041,36%,18-19,18-19 Orlando Magic,32.1097561,57,89.1097561
2019,2018-19,Detroit Pistons,82,19855,3185,7238,44%,993,2854,35%,2192,4384,50%,8778,-1530,39%,18-19,18-19 Detroit Pistons,34.80487805,53.46341463,88.26829268
2019,2018-19,Miami Heat,82,19730,3251,7218,45%,928,2658,35%,2323,4560,51%,8668,-1902,37%,18-19,18-19 Miami Heat,32.41463415,55.6097561,88.02439024
2019,2018-19,Chicago Bulls,82,19905,3266,7205,45%,745,2123,35%,2521,5082,50%,8605,-2959,29%,18-19,18-19 Chicago Bulls,25.8902439,61.97560976,87.86585366
2019,2018-19,New York Knicks,82,19780,3134,7241,43%,823,2421,34%,2311,4820,48%,8575,-2399,33%,18-19,18-19 New York Knicks,29.52439024,58.7804878,88.30487805
2019,2018-19,Cleveland Cavaliers,82,19755,3189,7184,44%,847,2388,36%,2342,4796,49%,8567,-2408,33%,18-19,18-19 Cleveland Cavaliers,29.12195122,58.48780488,87.6097561
2019,2018-19,Memphis Grizzlies,82,19880,3113,6924,45%,811,2368,34%,2302,4556,51%,8490,-2188,34%,18-19,18-19 Memphis Grizzlies,28.87804878,55.56097561,84.43902439
2018,2017-18,Golden State Warriors,82,19730,3509,6981,50%,926,2370,39%,2583,4611,56%,9304,-2241,34%,17-18,17-18 Golden State Warriors,28.90243902,56.23170732,85.13414634
2018,2017-18,Houston Rockets,82,19755,3174,6906,46%,1256,3470,36%,1918,3436,56%,9213,34,50%,17-18,17-18 Houston Rockets,42.31707317,41.90243902,84.2195122
2018,2017-18,New Orleans Pelicans,82,19955,3500,7241,48%,837,2312,36%,2663,4929,54%,9161,-2617,32%,17-18,17-18 New Orleans Pelicans,28.19512195,60.1097561,88.30487805
2018,2017-18,Toronto Raptors,82,19830,3383,7169,47%,968,2705,36%,2415,4464,54%,9156,-1759,38%,17-18,17-18 Toronto Raptors,32.98780488,54.43902439,87.42682927
2018,2017-18,Cleveland Cavaliers,82,19730,3311,6950,48%,981,2636,37%,2330,4314,54%,9091,-1678,38%,17-18,17-18 Cleveland Cavaliers,32.14634146,52.6097561,84.75609756
2018,2017-18,Denver Nuggets,82,19880,3338,7102,47%,940,2536,37%,2398,4566,53%,9020,-2030,36%,17-18,17-18 Denver Nuggets,30.92682927,55.68292683,86.6097561
2018,2017-18,Philadelphia 76ers,82,19780,3349,7098,47%,901,2445,37%,2448,4653,53%,9004,-2208,34%,17-18,17-18 Philadelphia 76ers,29.81707317,56.74390244,86.56097561
2018,2017-18,Minnesota Timberwolves,82,19805,3365,7063,48%,658,1845,36%,2707,5218,52%,8980,-3373,26%,17-18,17-18 Minnesota Timberwolves,22.5,63.63414634,86.13414634
2018,2017-18,Los Angeles Clippers,82,19705,3302,7004,47%,777,2196,35%,2525,4808,53%,8937,-2612,31%,17-18,17-18 Los Angeles Clippers,26.7804878,58.63414634,85.41463415
2018,2017-18,Charlotte Hornets,82,19780,3197,7106,45%,824,2233,37%,2373,4873,49%,8874,-2640,31%,17-18,17-18 Charlotte Hornets,27.23170732,59.42682927,86.65853659
2018,2017-18,Los Angeles Lakers,82,19905,3338,7248,46%,822,2384,35%,2516,4864,52%,8862,-2480,33%,17-18,17-18 Los Angeles Lakers,29.07317073,59.31707317,88.3902439
2018,2017-18,Oklahoma City Thunder,82,19830,3271,7221,45%,881,2491,35%,2390,4730,51%,8844,-2239,34%,17-18,17-18 Oklahoma City Thunder,30.37804878,57.68292683,88.06097561
2018,2017-18,Washington Wizards,82,19855,3275,7018,47%,814,2173,38%,2461,4845,51%,8742,-2672,31%,17-18,17-18 Washington Wizards,26.5,59.08536585,85.58536585
2018,2017-18,Brooklyn Nets,82,19855,3136,7114,44%,1041,2924,36%,2095,4190,50%,8741,-1266,41%,17-18,17-18 Brooklyn Nets,35.65853659,51.09756098,86.75609756
2018,2017-18,Milwaukee Bucks,82,19830,3257,6807,48%,718,2024,36%,2539,4783,53%,8731,-2759,30%,17-18,17-18 Milwaukee Bucks,24.68292683,58.32926829,83.01219512
2018,2017-18,Portland Trail Blazers,82,19755,3222,7132,45%,845,2308,37%,2377,4824,49%,8661,-2516,32%,17-18,17-18 Portland Trail Blazers,28.14634146,58.82926829,86.97560976
2018,2017-18,Indiana Pacers,82,19755,3345,7083,47%,741,2010,37%,2604,5073,51%,8656,-3063,28%,17-18,17-18 Indiana Pacers,24.51219512,61.86585366,86.37804878
2018,2017-18,New York Knicks,82,19830,3334,7193,46%,673,1914,35%,2661,5279,50%,8566,-3365,27%,17-18,17-18 New York Knicks,23.34146341,64.37804878,87.7195122
2018,2017-18,Utah Jazz,82,19755,3139,6797,46%,887,2425,37%,2252,4372,52%,8540,-1947,36%,17-18,17-18 Utah Jazz,29.57317073,53.31707317,82.8902439
2018,2017-18,Boston Celtics,82,19805,3141,6975,45%,939,2492,38%,2202,4483,49%,8529,-1991,36%,17-18,17-18 Boston Celtics,30.3902439,54.67073171,85.06097561
2018,2017-18,Phoenix Suns,82,19705,3153,7141,44%,763,2286,33%,2390,4855,49%,8522,-2569,32%,17-18,17-18 Phoenix Suns,27.87804878,59.20731707,87.08536585
2018,2017-18,Detroit Pistons,82,19805,3208,7129,45%,886,2373,37%,2322,4756,49%,8509,-2383,33%,17-18,17-18 Detroit Pistons,28.93902439,58,86.93902439
2018,2017-18,Miami Heat,82,19930,3184,6997,46%,903,2506,36%,2281,4491,51%,8480,-1985,36%,17-18,17-18 Miami Heat,30.56097561,54.76829268,85.32926829
2018,2017-18,Orlando Magic,82,19730,3182,7042,45%,844,2405,35%,2338,4637,50%,8479,-2232,34%,17-18,17-18 Orlando Magic,29.32926829,56.54878049,85.87804878
2018,2017-18,Atlanta Hawks,82,19705,3130,7015,45%,917,2544,36%,2213,4471,50%,8475,-1927,36%,17-18,17-18 Atlanta Hawks,31.02439024,54.52439024,85.54878049
2018,2017-18,Chicago Bulls,82,19855,3170,7285,44%,906,2549,36%,2264,4736,48%,8440,-2187,35%,17-18,17-18 Chicago Bulls,31.08536585,57.75609756,88.84146341
2018,2017-18,San Antonio Spurs,82,19730,3202,6999,46%,696,1977,35%,2506,5022,50%,8424,-3045,28%,17-18,17-18 San Antonio Spurs,24.1097561,61.24390244,85.35365854
2018,2017-18,Dallas Mavericks,82,19805,3128,7042,44%,967,2688,36%,2161,4354,50%,8390,-1666,38%,17-18,17-18 Dallas Mavericks,32.7804878,53.09756098,85.87804878
2018,2017-18,Memphis Grizzlies,82,19705,3013,6788,44%,758,2152,35%,2255,4636,49%,8145,-2484,32%,17-18,17-18 Memphis Grizzlies,26.24390244,56.53658537,82.7804878
2018,2017-18,Sacramento Kings,82,19755,3179,7063,45%,738,1967,38%,2441,5096,48%,8104,-3129,28%,17-18,17-18 Sacramento Kings,23.98780488,62.14634146,86.13414634
2017,2016-17,Golden State Warriors,82,19780,3532,7140,50%,982,2562,38%,2550,4578,56%,9503,-2016,36%,16-17,16-17 Golden State Warriors,31.24390244,55.82926829,87.07317073
2017,2016-17,Houston Rockets,82,19780,3305,7152,46%,1181,3306,36%,2124,3846,55%,9458,-540,46%,16-17,16-17 Houston Rockets,40.31707317,46.90243902,87.2195122
2017,2016-17,Denver Nuggets,82,19755,3377,7194,47%,870,2365,37%,2507,4829,52%,9161,-2464,33%,16-17,16-17 Denver Nuggets,28.84146341,58.8902439,87.73170732
2017,2016-17,Cleveland Cavaliers,82,19880,3275,6963,47%,1067,2779,38%,2208,4184,53%,9048,-1405,40%,16-17,16-17 Cleveland Cavaliers,33.8902439,51.02439024,84.91463415
2017,2016-17,Washington Wizards,82,19855,3388,7137,48%,756,2030,37%,2632,5107,52%,8953,-3077,28%,16-17,16-17 Washington Wizards,24.75609756,62.2804878,87.03658537
2017,2016-17,Los Angeles Clippers,82,19755,3242,6820,48%,841,2245,38%,2401,4575,53%,8911,-2330,33%,16-17,16-17 Los Angeles Clippers,27.37804878,55.79268293,83.17073171
2017,2016-17,Boston Celtics,82,19755,3168,6978,45%,985,2742,36%,2183,4236,52%,8857,-1494,39%,16-17,16-17 Boston Celtics,33.43902439,51.65853659,85.09756098
2017,2016-17,Portland Trail Blazers,82,19930,3243,7059,46%,852,2272,38%,2391,4787,50%,8851,-2515,32%,16-17,16-17 Portland Trail Blazers,27.70731707,58.37804878,86.08536585
2017,2016-17,Phoenix Suns,82,19830,3270,7260,45%,615,1854,33%,2655,5406,49%,8831,-3552,26%,16-17,16-17 Phoenix Suns,22.6097561,65.92682927,88.53658537
2017,2016-17,Toronto Raptors,82,19780,3211,6918,46%,725,1996,36%,2486,4922,51%,8762,-2926,29%,16-17,16-17 Toronto Raptors,24.34146341,60.02439024,84.36585366
2017,2016-17,Oklahoma City Thunder,82,19805,3237,7169,45%,692,2116,33%,2545,5053,50%,8741,-2937,30%,16-17,16-17 Oklahoma City Thunder,25.80487805,61.62195122,87.42682927
2017,2016-17,Brooklyn Nets,82,19755,3102,6987,44%,877,2591,34%,2225,4396,51%,8673,-1805,37%,16-17,16-17 Brooklyn Nets,31.59756098,53.6097561,85.20731707
2017,2016-17,Minnesota Timberwolves,82,19805,3235,6922,47%,601,1723,35%,2634,5199,51%,8657,-3476,25%,16-17,16-17 Minnesota Timberwolves,21.01219512,63.40243902,84.41463415
2017,2016-17,San Antonio Spurs,82,19805,3222,6864,47%,753,1927,39%,2469,4937,50%,8637,-3010,28%,16-17,16-17 San Antonio Spurs,23.5,60.20731707,83.70731707
2017,2016-17,Indiana Pacers,82,19855,3221,6931,47%,709,1885,38%,2512,5046,50%,8618,-3161,27%,16-17,16-17 Indiana Pacers,22.98780488,61.53658537,84.52439024
2017,2016-17,Charlotte Hornets,82,19830,3093,7000,44%,824,2347,35%,2269,4653,49%,8601,-2306,34%,16-17,16-17 Charlotte Hornets,28.62195122,56.74390244,85.36585366
2017,2016-17,Los Angeles Lakers,82,19705,3224,7164,45%,730,2110,35%,2494,5054,49%,8575,-2944,29%,16-17,16-17 Los Angeles Lakers,25.73170732,61.63414634,87.36585366
2017,2016-17,New Orleans Pelicans,82,19905,3210,7130,45%,768,2196,35%,2442,4934,50%,8556,-2738,31%,16-17,16-17 New Orleans Pelicans,26.7804878,60.17073171,86.95121951
2017,2016-17,New York Knicks,82,19855,3244,7256,45%,704,2022,35%,2540,5234,49%,8556,-3212,28%,16-17,16-17 New York Knicks,24.65853659,63.82926829,88.48780488
2017,2016-17,Milwaukee Bucks,82,19780,3182,6715,47%,720,1946,37%,2462,4769,52%,8497,-2823,29%,16-17,16-17 Milwaukee Bucks,23.73170732,58.15853659,81.8902439
2017,2016-17,Miami Heat,82,19780,3202,7037,46%,808,2213,37%,2394,4824,50%,8460,-2611,31%,16-17,16-17 Miami Heat,26.98780488,58.82926829,85.81707317
2017,2016-17,Atlanta Hawks,82,19880,3123,6918,45%,729,2137,34%,2394,4781,50%,8459,-2644,31%,16-17,16-17 Atlanta Hawks,26.06097561,58.30487805,84.36585366
2017,2016-17,Chicago Bulls,82,19780,3169,7141,44%,623,1831,34%,2546,5310,48%,8435,-3479,26%,16-17,16-17 Chicago Bulls,22.32926829,64.75609756,87.08536585
2017,2016-17,Sacramento Kings,82,19880,3105,6734,46%,737,1960,38%,2368,4774,50%,8430,-2814,29%,16-17,16-17 Sacramento Kings,23.90243902,58.2195122,82.12195122
2017,2016-17,Philadelphia 76ers,82,19830,3088,6992,44%,831,2443,34%,2257,4549,50%,8400,-2106,35%,16-17,16-17 Philadelphia 76ers,29.79268293,55.47560976,85.26829268
2017,2016-17,Detroit Pistons,82,19805,3269,7282,45%,631,1915,33%,2638,5367,49%,8309,-3452,26%,16-17,16-17 Detroit Pistons,23.35365854,65.45121951,88.80487805
2017,2016-17,Orlando Magic,82,19805,3139,7133,44%,701,2139,33%,2438,4994,49%,8288,-2855,30%,16-17,16-17 Orlando Magic,26.08536585,60.90243902,86.98780488
2017,2016-17,Utah Jazz,82,19755,3033,6515,47%,791,2128,37%,2242,4387,51%,8258,-2259,33%,16-17,16-17 Utah Jazz,25.95121951,53.5,79.45121951
2017,2016-17,Memphis Grizzlies,82,19905,2984,6854,44%,767,2169,35%,2217,4685,47%,8239,-2516,32%,16-17,16-17 Memphis Grizzlies,26.45121951,57.13414634,83.58536585
2017,2016-17,Dallas Mavericks,82,19780,2968,6750,44%,878,2473,36%,2090,4277,49%,8029,-1804,37%,16-17,16-17 Dallas Mavericks,30.15853659,52.15853659,82.31707317
2016,2015-16,Golden State Warriors,82,19880,3489,7159,49%,1077,2592,42%,2412,4567,53%,9421,-1975,36%,15-16,15-16 Golden State Warriors,31.6097561,55.69512195,87.30487805
2016,2015-16,Oklahoma City Thunder,82,19830,3372,7082,48%,678,1945,35%,2694,5137,52%,9038,-3192,27%,15-16,15-16 Oklahoma City Thunder,23.7195122,62.64634146,86.36585366
2016,2015-16,Sacramento Kings,82,19805,3283,7083,46%,660,1839,36%,2623,5244,50%,8740,-3405,26%,15-16,15-16 Sacramento Kings,22.42682927,63.95121951,86.37804878
2016,2015-16,Houston Rockets,82,19830,3094,6847,45%,878,2533,35%,2216,4314,51%,8737,-1781,37%,15-16,15-16 Houston Rockets,30.8902439,52.6097561,83.5
2016,2015-16,Boston Celtics,82,19780,3216,7318,44%,717,2142,34%,2499,5176,48%,8669,-3034,29%,15-16,15-16 Boston Celtics,26.12195122,63.12195122,89.24390244
2016,2015-16,Portland Trail Blazers,82,19805,3167,7040,45%,864,2336,37%,2303,4704,49%,8622,-2368,33%,15-16,15-16 Portland Trail Blazers,28.48780488,57.36585366,85.85365854
2016,2015-16,Los Angeles Clippers,82,19830,3141,6759,47%,797,2190,36%,2344,4569,51%,8569,-2379,32%,15-16,15-16 Los Angeles Clippers,26.70731707,55.7195122,82.42682927
2016,2015-16,Cleveland Cavaliers,82,19855,3171,6888,46%,880,2428,36%,2291,4460,51%,8555,-2032,35%,15-16,15-16 Cleveland Cavaliers,29.6097561,54.3902439,84
2016,2015-16,Washington Wizards,82,19755,3238,7033,46%,709,1983,36%,2529,5050,50%,8534,-3067,28%,15-16,15-16 Washington Wizards,24.18292683,61.58536585,85.76829268
2016,2015-16,San Antonio Spurs,82,19705,3289,6797,48%,570,1518,38%,2719,5279,52%,8490,-3761,22%,15-16,15-16 San Antonio Spurs,18.51219512,64.37804878,82.8902439
2016,2015-16,Charlotte Hornets,82,19855,3036,6922,44%,873,2410,36%,2163,4512,48%,8479,-2102,35%,15-16,15-16 Charlotte Hornets,29.3902439,55.02439024,84.41463415
2016,2015-16,Atlanta Hawks,82,19830,3168,6923,46%,815,2326,35%,2353,4597,51%,8433,-2271,34%,15-16,15-16 Atlanta Hawks,28.36585366,56.06097561,84.42682927
2016,2015-16,New Orleans Pelicans,82,19780,3153,7040,45%,702,1951,36%,2451,5089,48%,8423,-3138,28%,15-16,15-16 New Orleans Pelicans,23.79268293,62.06097561,85.85365854
2016,2015-16,Toronto Raptors,82,19780,3006,6669,45%,708,1915,37%,2298,4754,48%,8422,-2839,29%,15-16,15-16 Toronto Raptors,23.35365854,57.97560976,81.32926829
2016,2015-16,Minnesota Timberwolves,82,19880,3095,6668,46%,455,1347,34%,2640,5321,50%,8398,-3974,20%,15-16,15-16 Minnesota Timberwolves,16.42682927,64.8902439,81.31707317
2016,2015-16,Dallas Mavericks,82,20005,3064,6900,44%,806,2342,34%,2258,4558,50%,8388,-2216,34%,15-16,15-16 Dallas Mavericks,28.56097561,55.58536585,84.14634146
2016,2015-16,Indiana Pacers,82,19880,3142,6985,45%,663,1889,35%,2479,5096,49%,8377,-3207,27%,15-16,15-16 Indiana Pacers,23.03658537,62.14634146,85.18292683
2016,2015-16,Orlando Magic,82,19905,3242,7120,46%,636,1818,35%,2606,5302,49%,8369,-3484,26%,15-16,15-16 Orlando Magic,22.17073171,64.65853659,86.82926829
2016,2015-16,Detroit Pistons,82,19880,3111,7087,44%,740,2148,35%,2371,4939,48%,8361,-2791,30%,15-16,15-16 Detroit Pistons,26.19512195,60.23170732,86.42682927
2016,2015-16,Denver Nuggets,82,19830,3093,7003,44%,656,1943,34%,2437,5060,48%,8355,-3117,28%,15-16,15-16 Denver Nuggets,23.69512195,61.70731707,85.40243902
2016,2015-16,Chicago Bulls,82,19905,3165,7170,44%,651,1753,37%,2514,5417,46%,8335,-3664,24%,15-16,15-16 Chicago Bulls,21.37804878,66.06097561,87.43902439
2016,2015-16,Phoenix Suns,82,19705,3051,7018,44%,738,2118,35%,2313,4900,47%,8271,-2782,30%,15-16,15-16 Phoenix Suns,25.82926829,59.75609756,85.58536585
2016,2015-16,Miami Heat,82,19830,3150,6697,47%,498,1480,34%,2652,5217,51%,8204,-3737,22%,15-16,15-16 Miami Heat,18.04878049,63.62195122,81.67073171
2016,2015-16,Memphis Grizzlies,82,19830,3019,6859,44%,504,1521,33%,2515,5338,47%,8126,-3817,22%,15-16,15-16 Memphis Grizzlies,18.54878049,65.09756098,83.64634146
2016,2015-16,Milwaukee Bucks,82,19830,3145,6740,47%,440,1277,35%,2705,5463,50%,8122,-4186,19%,15-16,15-16 Milwaukee Bucks,15.57317073,66.62195122,82.19512195
2016,2015-16,Brooklyn Nets,82,19755,3136,6920,45%,531,1508,35%,2605,5412,48%,8089,-3904,22%,15-16,15-16 Brooklyn Nets,18.3902439,66,84.3902439
2016,2015-16,New York Knicks,82,19805,3022,6886,44%,610,1762,35%,2412,5124,47%,8065,-3362,26%,15-16,15-16 New York Knicks,21.48780488,62.48780488,83.97560976
2016,2015-16,Utah Jazz,82,19955,2957,6593,45%,694,1956,36%,2263,4637,49%,8010,-2681,30%,15-16,15-16 Utah Jazz,23.85365854,56.54878049,80.40243902
2016,2015-16,Philadelphia 76ers,82,19805,2970,6887,43%,764,2255,34%,2206,4632,48%,7988,-2377,33%,15-16,15-16 Philadelphia 76ers,27.5,56.48780488,83.98780488
2016,2015-16,Los Angeles Lakers,82,19730,2880,6956,41%,639,2016,32%,2241,4940,45%,7982,-2924,29%,15-16,15-16 Los Angeles Lakers,24.58536585,60.24390244,84.82926829
2015,2014-15,Golden State Warriors,82,19730,3410,7137,48%,883,2217,40%,2527,4920,51%,9016,-2703,31%,14-15,14-15 Golden State Warriors,27.03658537,60,87.03658537
2015,2014-15,Los Angeles Clippers,82,19730,3228,6830,47%,827,2202,38%,2401,4628,52%,8751,-2426,32%,14-15,14-15 Los Angeles Clippers,26.85365854,56.43902439,83.29268293
2015,2014-15,Dallas Mavericks,82,19880,3255,7036,46%,732,2082,35%,2523,4954,51%,8628,-2872,30%,14-15,14-15 Dallas Mavericks,25.3902439,60.41463415,85.80487805
2015,2014-15,Toronto Raptors,82,19855,3108,6829,46%,726,2060,35%,2382,4769,50%,8527,-2709,30%,14-15,14-15 Toronto Raptors,25.12195122,58.15853659,83.2804878
2015,2014-15,Oklahoma City Thunder,82,19830,3184,7119,45%,632,1864,34%,2552,5255,49%,8524,-3391,26%,14-15,14-15 Oklahoma City Thunder,22.73170732,64.08536585,86.81707317
2015,2014-15,Houston Rockets,82,19805,3032,6832,44%,933,2680,35%,2099,4152,51%,8522,-1472,39%,14-15,14-15 Houston Rockets,32.68292683,50.63414634,83.31707317
2015,2014-15,San Antonio Spurs,82,19955,3208,6854,47%,677,1847,37%,2531,5007,51%,8461,-3160,27%,14-15,14-15 San Antonio Spurs,22.52439024,61.06097561,83.58536585
2015,2014-15,Cleveland Cavaliers,82,19780,3089,6739,46%,826,2253,37%,2263,4486,50%,8457,-2233,33%,14-15,14-15 Cleveland Cavaliers,27.47560976,54.70731707,82.18292683
2015,2014-15,Portland Trail Blazers,82,19855,3175,7049,45%,807,2231,36%,2368,4818,49%,8429,-2587,32%,14-15,14-15 Portland Trail Blazers,27.20731707,58.75609756,85.96341463
2015,2014-15,Atlanta Hawks,82,19730,3121,6699,47%,818,2152,38%,2303,4547,51%,8409,-2395,32%,14-15,14-15 Atlanta Hawks,26.24390244,55.45121951,81.69512195
2015,2014-15,Phoenix Suns,82,19880,3178,7038,45%,698,2048,34%,2480,4990,50%,8397,-2942,29%,14-15,14-15 Phoenix Suns,24.97560976,60.85365854,85.82926829
2015,2014-15,Denver Nuggets,82,19880,3099,7158,43%,660,2032,33%,2439,5126,48%,8320,-3094,28%,14-15,14-15 Denver Nuggets,24.7804878,62.51219512,87.29268293
2015,2014-15,Boston Celtics,82,19880,3193,7211,44%,660,2021,33%,2533,5190,49%,8312,-3169,28%,14-15,14-15 Boston Celtics,24.64634146,63.29268293,87.93902439
2015,2014-15,Sacramento Kings,82,19855,3010,6617,46%,461,1350,34%,2549,5267,48%,8310,-3917,20%,14-15,14-15 Sacramento Kings,16.46341463,64.23170732,80.69512195
2015,2014-15,Chicago Bulls,82,19880,3001,6797,44%,645,1825,35%,2356,4972,47%,8265,-3147,27%,14-15,14-15 Chicago Bulls,22.25609756,60.63414634,82.8902439
2015,2014-15,New Orleans Pelicans,82,19780,3108,6795,46%,586,1583,37%,2522,5212,48%,8147,-3629,23%,14-15,14-15 New Orleans Pelicans,19.30487805,63.56097561,82.86585366
2015,2014-15,Washington Wizards,82,19955,3139,6790,46%,497,1381,36%,2642,5409,49%,8080,-4028,20%,14-15,14-15 Washington Wizards,16.84146341,65.96341463,82.80487805
2015,2014-15,Detroit Pistons,82,19830,3041,7038,43%,703,2043,34%,2338,4995,47%,8077,-2952,29%,14-15,14-15 Detroit Pistons,24.91463415,60.91463415,85.82926829
2015,2014-15,Los Angeles Lakers,82,19930,3054,7020,44%,532,1546,34%,2522,5474,46%,8073,-3928,22%,14-15,14-15 Los Angeles Lakers,18.85365854,66.75609756,85.6097561
2015,2014-15,Memphis Grizzlies,82,19905,3097,6763,46%,423,1246,34%,2674,5517,49%,8062,-4271,18%,14-15,14-15 Memphis Grizzlies,15.19512195,67.2804878,82.47560976
2015,2014-15,Brooklyn Nets,82,19930,3069,6804,45%,541,1633,33%,2528,5171,49%,8038,-3538,24%,14-15,14-15 Brooklyn Nets,19.91463415,63.06097561,82.97560976
2015,2014-15,Milwaukee Bucks,82,19930,3083,6722,46%,545,1500,36%,2538,5222,49%,8023,-3722,22%,14-15,14-15 Milwaukee Bucks,18.29268293,63.68292683,81.97560976
2015,2014-15,Minnesota Timberwolves,82,19805,2986,6820,44%,406,1223,33%,2580,5597,46%,8016,-4374,18%,14-15,14-15 Minnesota Timberwolves,14.91463415,68.25609756,83.17073171
2015,2014-15,Indiana Pacers,82,19855,2998,6824,44%,612,1740,35%,2386,5084,47%,7981,-3344,25%,14-15,14-15 Indiana Pacers,21.2195122,62,83.2195122
2015,2014-15,Orlando Magic,82,19755,3076,6792,45%,554,1598,35%,2522,5194,49%,7847,-3596,24%,14-15,14-15 Orlando Magic,19.48780488,63.34146341,82.82926829
2015,2014-15,Utah Jazz,82,19705,2900,6492,45%,610,1781,34%,2290,4711,49%,7801,-2930,27%,14-15,14-15 Utah Jazz,21.7195122,57.45121951,79.17073171
2015,2014-15,Miami Heat,82,19730,2885,6330,46%,556,1659,34%,2329,4671,50%,7764,-3012,26%,14-15,14-15 Miami Heat,20.23170732,56.96341463,77.19512195
2015,2014-15,Charlotte Hornets,82,19905,2913,6932,42%,498,1566,32%,2415,5366,45%,7721,-3800,23%,14-15,14-15 Charlotte Hornets,19.09756098,65.43902439,84.53658537
2015,2014-15,Philadelphia 76ers,82,19805,2765,6777,41%,692,2160,32%,2073,4617,45%,7542,-2457,32%,14-15,14-15 Philadelphia 76ers,26.34146341,56.30487805,82.64634146
2015,2014-15,New York Knicks,82,19855,2882,6726,43%,560,1614,35%,2322,5112,45%,7535,-3498,24%,14-15,14-15 New York Knicks,19.68292683,62.34146341,82.02439024
2014,2013-14,Los Angeles Clippers,82,19755,3208,6761,47%,693,1966,35%,2515,4795,53%,8850,-2829,29%,13-14,13-14 Los Angeles Clippers,23.97560976,58.47560976,82.45121951
2014,2013-14,Houston Rockets,82,19830,3118,6603,47%,779,2179,36%,2339,4424,53%,8829,-2245,33%,13-14,13-14 Houston Rockets,26.57317073,53.95121951,80.52439024
2014,2013-14,Minnesota Timberwolves,82,19855,3189,7175,44%,600,1757,34%,2589,5418,48%,8768,-3661,24%,13-14,13-14 Minnesota Timberwolves,21.42682927,66.07317073,87.5
2014,2013-14,Portland Trail Blazers,82,19855,3207,7134,45%,770,2071,37%,2437,5063,48%,8753,-2992,29%,13-14,13-14 Portland Trail Blazers,25.25609756,61.74390244,87
2014,2013-14,Oklahoma City Thunder,82,19805,3194,6782,47%,664,1839,36%,2530,4943,51%,8705,-3104,27%,13-14,13-14 Oklahoma City Thunder,22.42682927,60.2804878,82.70731707
2014,2013-14,San Antonio Spurs,82,19755,3326,6844,49%,698,1757,40%,2628,5087,52%,8639,-3330,26%,13-14,13-14 San Antonio Spurs,21.42682927,62.03658537,83.46341463
2014,2013-14,Phoenix Suns,82,19755,3172,6845,46%,765,2055,37%,2407,4790,50%,8629,-2735,30%,13-14,13-14 Phoenix Suns,25.06097561,58.41463415,83.47560976
2014,2013-14,Dallas Mavericks,82,19830,3249,6858,47%,721,1877,38%,2528,4981,51%,8597,-3104,27%,13-14,13-14 Dallas Mavericks,22.8902439,60.74390244,83.63414634
2014,2013-14,Denver Nuggets,82,19755,3147,7042,45%,702,1959,36%,2445,5083,48%,8559,-3124,28%,13-14,13-14 Denver Nuggets,23.8902439,61.98780488,85.87804878
2014,2013-14,Golden State Warriors,82,19830,3236,7005,46%,774,2037,38%,2462,4968,50%,8549,-2931,29%,13-14,13-14 Golden State Warriors,24.84146341,60.58536585,85.42682927
2014,2013-14,Los Angeles Lakers,82,19705,3139,6980,45%,774,2032,38%,2365,4948,48%,8442,-2916,29%,13-14,13-14 Los Angeles Lakers,24.7804878,60.34146341,85.12195122
2014,2013-14,Miami Heat,82,19880,3142,6272,50%,665,1829,36%,2477,4443,56%,8380,-2614,29%,13-14,13-14 Miami Heat,22.30487805,54.18292683,76.48780488
2014,2013-14,Toronto Raptors,82,19955,2992,6718,45%,713,1917,37%,2279,4801,48%,8305,-2884,29%,13-14,13-14 Toronto Raptors,23.37804878,58.54878049,81.92682927
2014,2013-14,Detroit Pistons,82,19780,3182,7124,45%,507,1580,32%,2675,5544,48%,8286,-3964,22%,13-14,13-14 Detroit Pistons,19.26829268,67.6097561,86.87804878
2014,2013-14,Atlanta Hawks,82,19830,3061,6688,46%,768,2116,36%,2293,4572,50%,8282,-2456,32%,13-14,13-14 Atlanta Hawks,25.80487805,55.75609756,81.56097561
2014,2013-14,Washington Wizards,82,20055,3177,6920,46%,647,1704,38%,2530,5216,49%,8254,-3512,25%,13-14,13-14 Washington Wizards,20.7804878,63.6097561,84.3902439
2014,2013-14,Sacramento Kings,82,19830,3026,6766,45%,491,1475,33%,2535,5291,48%,8241,-3816,22%,13-14,13-14 Sacramento Kings,17.98780488,64.52439024,82.51219512
2014,2013-14,New Orleans Pelicans,82,19855,3101,6761,46%,486,1303,37%,2615,5458,48%,8177,-4155,19%,13-14,13-14 New Orleans Pelicans,15.8902439,66.56097561,82.45121951
2014,2013-14,Philadelphia 76ers,82,19855,3108,7150,44%,577,1847,31%,2531,5303,48%,8155,-3456,26%,13-14,13-14 Philadelphia 76ers,22.52439024,64.67073171,87.19512195
2014,2013-14,New York Knicks,82,19855,3027,6739,45%,759,2038,37%,2268,4701,48%,8084,-2663,30%,13-14,13-14 New York Knicks,24.85365854,57.32926829,82.18292683
2014,2013-14,Brooklyn Nets,82,19880,2931,6391,46%,709,1922,37%,2222,4469,50%,8079,-2547,30%,13-14,13-14 Brooklyn Nets,23.43902439,54.5,77.93902439
2014,2013-14,Cleveland Cavaliers,82,19930,3036,6955,44%,584,1640,36%,2452,5315,46%,8054,-3675,24%,13-14,13-14 Cleveland Cavaliers,20,64.81707317,84.81707317
2014,2013-14,Charlotte Bobcats,82,19905,2976,6730,44%,516,1471,35%,2460,5259,47%,7942,-3788,22%,13-14,13-14 Charlotte Bobcats,17.93902439,64.13414634,82.07317073
2014,2013-14,Indiana Pacers,82,19780,2949,6573,45%,550,1542,36%,2399,5031,48%,7933,-3489,23%,13-14,13-14 Indiana Pacers,18.80487805,61.35365854,80.15853659
2014,2013-14,Orlando Magic,82,19955,3022,6784,45%,563,1596,35%,2459,5188,47%,7914,-3592,24%,13-14,13-14 Orlando Magic,19.46341463,63.26829268,82.73170732
2014,2013-14,Boston Celtics,82,19730,2996,6883,44%,575,1729,33%,2421,5154,47%,7892,-3425,25%,13-14,13-14 Boston Celtics,21.08536585,62.85365854,83.93902439
2014,2013-14,Memphis Grizzlies,82,19805,3122,6723,46%,405,1147,35%,2717,5576,49%,7884,-4429,17%,13-14,13-14 Memphis Grizzlies,13.98780488,68,81.98780488
2014,2013-14,Milwaukee Bucks,82,19880,2952,6737,44%,548,1553,35%,2404,5184,46%,7829,-3631,23%,13-14,13-14 Milwaukee Bucks,18.93902439,63.2195122,82.15853659
2014,2013-14,Utah Jazz,82,19780,2951,6652,44%,543,1577,34%,2408,5075,47%,7791,-3498,24%,13-14,13-14 Utah Jazz,19.23170732,61.8902439,81.12195122
2014,2013-14,Chicago Bulls,82,19930,2843,6577,43%,508,1459,35%,2335,5118,46%,7680,-3659,22%,13-14,13-14 Chicago Bulls,17.79268293,62.41463415,80.20731707
2013,2012-13,Denver Nuggets,82,19905,3339,6983,48%,521,1518,34%,2818,5465,52%,8704,-3947,22%,12-13,12-13 Denver Nuggets,18.51219512,66.64634146,85.15853659
2013,2012-13,Houston Rockets,82,19780,3124,6782,46%,867,2369,37%,2257,4413,51%,8688,-2044,35%,12-13,12-13 Houston Rockets,28.8902439,53.81707317,82.70731707
2013,2012-13,Oklahoma City Thunder,82,19830,3126,6504,48%,598,1588,38%,2528,4916,51%,8669,-3328,24%,12-13,12-13 Oklahoma City Thunder,19.36585366,59.95121951,79.31707317
2013,2012-13,San Antonio Spurs,82,19880,3210,6675,48%,663,1764,38%,2547,4911,52%,8448,-3147,26%,12-13,12-13 San Antonio Spurs,21.51219512,59.8902439,81.40243902
2013,2012-13,Miami Heat,82,19880,3148,6348,50%,717,1809,40%,2431,4539,54%,8436,-2730,28%,12-13,12-13 Miami Heat,22.06097561,55.35365854,77.41463415
2013,2012-13,Los Angeles Lakers,82,19755,3041,6640,46%,715,2015,36%,2326,4625,50%,8381,-2610,30%,12-13,12-13 Los Angeles Lakers,24.57317073,56.40243902,80.97560976
2013,2012-13,Golden State Warriors,82,19805,3130,6840,46%,658,1632,40%,2472,5208,48%,8296,-3576,24%,12-13,12-13 Golden State Warriors,19.90243902,63.51219512,83.41463415
2013,2012-13,Dallas Mavericks,82,19980,3182,6892,46%,606,1628,37%,2576,5264,49%,8293,-3636,24%,12-13,12-13 Dallas Mavericks,19.85365854,64.19512195,84.04878049
2013,2012-13,Los Angeles Clippers,82,19730,3160,6608,48%,627,1752,36%,2533,4856,52%,8289,-3104,27%,12-13,12-13 Los Angeles Clippers,21.36585366,59.2195122,80.58536585
2013,2012-13,Sacramento Kings,82,19830,3086,6904,45%,610,1681,36%,2476,5223,47%,8219,-3542,24%,12-13,12-13 Sacramento Kings,20.5,63.69512195,84.19512195
2013,2012-13,New York Knicks,82,19730,2996,6689,45%,891,2371,38%,2105,4318,49%,8196,-1947,35%,12-13,12-13 New York Knicks,28.91463415,52.65853659,81.57317073
2013,2012-13,Milwaukee Bucks,82,19830,3128,7197,44%,601,1670,36%,2527,5527,46%,8108,-3857,23%,12-13,12-13 Milwaukee Bucks,20.36585366,67.40243902,87.76829268
2013,2012-13,Utah Jazz,82,19880,3046,6710,45%,507,1385,37%,2539,5325,48%,8038,-3940,21%,12-13,12-13 Utah Jazz,16.8902439,64.93902439,81.82926829
2013,2012-13,Atlanta Hawks,82,19855,3084,6644,46%,706,1901,37%,2378,4743,50%,8032,-2842,29%,12-13,12-13 Atlanta Hawks,23.18292683,57.84146341,81.02439024
2013,2012-13,Portland Trail Blazers,82,19855,3009,6715,45%,673,1904,35%,2336,4811,49%,7995,-2907,28%,12-13,12-13 Portland Trail Blazers,23.2195122,58.67073171,81.8902439
2013,2012-13,Toronto Raptors,82,19980,2979,6685,45%,571,1665,34%,2408,5020,48%,7971,-3355,25%,12-13,12-13 Toronto Raptors,20.30487805,61.2195122,81.52439024
2013,2012-13,Brooklyn Nets,82,19855,2942,6544,45%,628,1760,36%,2314,4784,48%,7944,-3024,27%,12-13,12-13 Brooklyn Nets,21.46341463,58.34146341,79.80487805
2013,2012-13,Cleveland Cavaliers,82,19730,2993,6901,43%,547,1581,35%,2446,5320,46%,7913,-3739,23%,12-13,12-13 Cleveland Cavaliers,19.2804878,64.87804878,84.15853659
2013,2012-13,Minnesota Timberwolves,82,19730,2943,6702,44%,450,1475,31%,2493,5227,48%,7851,-3752,22%,12-13,12-13 Minnesota Timberwolves,17.98780488,63.74390244,81.73170732
2013,2012-13,Boston Celtics,81,19840,3001,6459,47%,498,1390,36%,2503,5069,49%,7818,-3679,22%,12-13,12-13 Boston Celtics,17.16049383,62.58024691,79.74074074
2013,2012-13,Phoenix Suns,82,19805,3061,6917,44%,480,1455,33%,2581,5462,47%,7805,-4007,21%,12-13,12-13 Phoenix Suns,17.74390244,66.6097561,84.35365854
2013,2012-13,Detroit Pistons,82,19805,2979,6638,45%,513,1440,36%,2466,5198,47%,7778,-3758,22%,12-13,12-13 Detroit Pistons,17.56097561,63.3902439,80.95121951
2013,2012-13,Orlando Magic,82,19780,3093,6904,45%,506,1537,33%,2587,5367,48%,7718,-3830,22%,12-13,12-13 Orlando Magic,18.74390244,65.45121951,84.19512195
2013,2012-13,New Orleans Hornets,82,19780,2955,6589,45%,535,1474,36%,2420,5115,47%,7714,-3641,22%,12-13,12-13 New Orleans Hornets,17.97560976,62.37804878,80.35365854
2013,2012-13,Indiana Pacers,81,19590,2845,6525,44%,555,1599,35%,2290,4926,47%,7674,-3327,25%,12-13,12-13 Indiana Pacers,19.74074074,60.81481481,80.55555556
2013,2012-13,Charlotte Bobcats,82,19805,2823,6649,43%,469,1399,34%,2354,5250,45%,7661,-3851,21%,12-13,12-13 Charlotte Bobcats,17.06097561,64.02439024,81.08536585
2013,2012-13,Memphis Grizzlies,82,19805,2964,6679,44%,382,1107,35%,2582,5572,46%,7659,-4465,17%,12-13,12-13 Memphis Grizzlies,13.5,67.95121951,81.45121951
2013,2012-13,Washington Wizards,82,19855,2910,6693,44%,545,1495,37%,2365,5198,46%,7644,-3703,22%,12-13,12-13 Washington Wizards,18.23170732,63.3902439,81.62195122
2013,2012-13,Chicago Bulls,82,19830,2926,6698,44%,446,1265,35%,2480,5433,46%,7641,-4168,19%,12-13,12-13 Chicago Bulls,15.42682927,66.25609756,81.68292683
2012,2012-13,Philadelphia 76ers,82,19755,3059,6895,44%,518,1438,36%,2541,5457,47%,7640,-4019,21%,12-13,12-13 Philadelphia 76ers,17.53658537,66.54878049,84.08536585
2012,2011-12,Denver Nuggets,66,16040,2572,5404,48%,435,1311,33%,2137,4093,52%,6872,-2782,24%,11-12,11-12 Denver Nuggets,19.86363636,62.01515152,81.87878788
2012,2011-12,San Antonio Spurs,66,15940,2611,5463,48%,552,1405,39%,2059,4058,51%,6841,-2653,26%,11-12,11-12 San Antonio Spurs,21.28787879,61.48484848,82.77272727
2012,2011-12,Oklahoma City Thunder,66,15990,2462,5229,47%,472,1317,36%,1990,3912,51%,6802,-2595,25%,11-12,11-12 Oklahoma City Thunder,19.95454545,59.27272727,79.22727273
2012,2011-12,Utah Jazz,66,16165,2523,5531,46%,273,845,32%,2250,4686,48%,6577,-3841,15%,11-12,11-12 Utah Jazz,12.8030303,71,83.8030303
2012,2011-12,Milwaukee Bucks,66,15865,2502,5652,44%,436,1265,35%,2066,4387,47%,6535,-3122,22%,11-12,11-12 Milwaukee Bucks,19.16666667,66.46969697,85.63636364
2012,2011-12,Sacramento Kings,66,15915,2490,5712,44%,411,1301,32%,2079,4411,47%,6518,-3110,23%,11-12,11-12 Sacramento Kings,19.71212121,66.83333333,86.54545455
2012,2011-12,Miami Heat,66,16040,2446,5212,47%,370,1030,36%,2076,4182,50%,6500,-3152,20%,11-12,11-12 Miami Heat,15.60606061,63.36363636,78.96969697
2012,2011-12,Phoenix Suns,66,15840,2495,5445,46%,444,1295,34%,2051,4150,49%,6492,-2855,24%,11-12,11-12 Phoenix Suns,19.62121212,62.87878788,82.5
2012,2011-12,Houston Rockets,66,16065,2489,5543,45%,478,1330,36%,2011,4213,48%,6474,-2883,24%,11-12,11-12 Houston Rockets,20.15151515,63.83333333,83.98484848
2012,2011-12,Minnesota Timberwolves,66,15940,2355,5434,43%,473,1423,33%,1882,4011,47%,6464,-2588,26%,11-12,11-12 Minnesota Timberwolves,21.56060606,60.77272727,82.33333333
2012,2011-12,New York Knicks,66,15940,2365,5335,44%,517,1538,34%,1848,3797,49%,6458,-2259,29%,11-12,11-12 New York Knicks,23.3030303,57.53030303,80.83333333
2012,2011-12,Golden State Warriors,66,15915,2489,5443,46%,524,1351,39%,1965,4092,48%,6453,-2741,25%,11-12,11-12 Golden State Warriors,20.46969697,62,82.46969697
2012,2011-12,Indiana Pacers,66,15990,2354,5375,44%,392,1064,37%,1962,4311,46%,6449,-3247,20%,11-12,11-12 Indiana Pacers,16.12121212,65.31818182,81.43939394
2012,2011-12,Los Angeles Clippers,66,15965,2439,5366,46%,514,1441,36%,1925,3925,49%,6438,-2484,27%,11-12,11-12 Los Angeles Clippers,21.83333333,59.46969697,81.3030303
2012,2011-12,Los Angeles Lakers,66,16065,2429,5319,46%,362,1112,33%,2067,4207,49%,6422,-3095,21%,11-12,11-12 Los Angeles Lakers,16.84848485,63.74242424,80.59090909
2012,2011-12,Portland Trail Blazers,66,15965,2402,5417,44%,478,1382,35%,1924,4035,48%,6415,-2653,26%,11-12,11-12 Portland Trail Blazers,20.93939394,61.13636364,82.07575758
2012,2011-12,Atlanta Hawks,66,16165,2429,5348,45%,492,1330,37%,1937,4018,48%,6375,-2688,25%,11-12,11-12 Atlanta Hawks,20.15151515,60.87878788,81.03030303
2012,2011-12,Chicago Bulls,66,15940,2467,5462,45%,419,1117,38%,2048,4345,47%,6359,-3228,20%,11-12,11-12 Chicago Bulls,16.92424242,65.83333333,82.75757576
2012,2011-12,Dallas Mavericks,66,16065,2398,5412,44%,497,1464,34%,1901,3948,48%,6322,-2484,27%,11-12,11-12 Dallas Mavericks,22.18181818,59.81818182,82
2012,2011-12,Memphis Grizzlies,66,15940,2425,5422,45%,277,849,33%,2148,4573,47%,6269,-3724,16%,11-12,11-12 Memphis Grizzlies,12.86363636,69.28787879,82.15151515
2012,2011-12,Orlando Magic,66,15965,2275,5162,44%,670,1785,38%,1605,3377,48%,6215,-1592,35%,11-12,11-12 Orlando Magic,27.04545455,51.16666667,78.21212121
2012,2011-12,Washington Wizards,66,15865,2414,5475,44%,344,1075,32%,2070,4400,47%,6180,-3325,20%,11-12,11-12 Washington Wizards,16.28787879,66.66666667,82.95454545
2012,2011-12,Philadelphia 76ers,66,15915,2471,5516,45%,349,963,36%,2122,4553,47%,6180,-3590,17%,11-12,11-12 Philadelphia 76ers,14.59090909,68.98484848,83.57575758
2012,2011-12,New Jersey Nets,66,15890,2262,5320,43%,507,1481,34%,1755,3839,46%,6144,-2358,28%,11-12,11-12 New Jersey Nets,22.43939394,58.16666667,80.60606061
2012,2011-12,Cleveland Cavaliers,66,15965,2261,5360,42%,440,1273,35%,1821,4087,45%,6140,-2814,24%,11-12,11-12 Cleveland Cavaliers,19.28787879,61.92424242,81.21212121
2012,2011-12,Boston Celtics,66,15940,2341,5086,46%,363,988,37%,1978,4098,48%,6062,-3110,19%,11-12,11-12 Boston Celtics,14.96969697,62.09090909,77.06060606
2012,2011-12,Detroit Pistons,66,15965,2291,5232,44%,317,916,35%,1974,4316,46%,5997,-3400,18%,11-12,11-12 Detroit Pistons,13.87878788,65.39393939,79.27272727
2012,2011-12,Toronto Raptors,66,15965,2268,5154,44%,365,1075,34%,1903,4079,47%,5986,-3004,21%,11-12,11-12 Toronto Raptors,16.28787879,61.8030303,78.09090909
2012,2011-12,New Orleans Hornets,66,15940,2300,5103,45%,259,777,33%,2041,4326,47%,5916,-3549,15%,11-12,11-12 New Orleans Hornets,11.77272727,65.54545455,77.31818182
2012,2011-12,Charlotte Bobcats,66,15890,2193,5293,41%,263,892,30%,1930,4401,44%,5739,-3509,17%,11-12,11-12 Charlotte Bobcats,13.51515152,66.68181818,80.1969697
2011,2010-11,Denver Nuggets,82,19705,3145,6613,48%,662,1704,39%,2483,4909,51%,8811,-3205,26%,10-11,10-11 Denver Nuggets,20.7804878,59.86585366,80.64634146
2011,2010-11,New York Knicks,82,19780,3140,6867,46%,765,2081,37%,2375,4786,50%,8734,-2705,30%,10-11,10-11 New York Knicks,25.37804878,58.36585366,83.74390244
2011,2010-11,Houston Rockets,82,19880,3170,6975,45%,677,1843,37%,2493,5132,49%,8685,-3289,26%,10-11,10-11 Houston Rockets,22.47560976,62.58536585,85.06097561
2011,2010-11,Phoenix Suns,82,20005,3219,6844,47%,701,1857,38%,2518,4987,51%,8611,-3130,27%,10-11,10-11 Phoenix Suns,22.64634146,60.81707317,83.46341463
2011,2010-11,Oklahoma City Thunder,82,20005,3066,6609,46%,487,1403,35%,2579,5206,50%,8596,-3803,21%,10-11,10-11 Oklahoma City Thunder,17.1097561,63.48780488,80.59756098
2011,2010-11,San Antonio Spurs,82,19780,3148,6628,48%,685,1727,40%,2463,4901,50%,8502,-3174,26%,10-11,10-11 San Antonio Spurs,21.06097561,59.76829268,80.82926829
2011,2010-11,Golden State Warriors,82,19830,3251,7047,46%,685,1749,39%,2566,5298,48%,8477,-3549,25%,10-11,10-11 Golden State Warriors,21.32926829,64.6097561,85.93902439
2011,2010-11,Miami Heat,82,19780,3031,6301,48%,547,1479,37%,2484,4822,52%,8369,-3343,23%,10-11,10-11 Miami Heat,18.03658537,58.80487805,76.84146341
2011,2010-11,Los Angeles Lakers,82,19830,3128,6757,46%,524,1487,35%,2604,5270,49%,8321,-3783,22%,10-11,10-11 Los Angeles Lakers,18.13414634,64.26829268,82.40243902
2011,2010-11,Minnesota Timberwolves,82,19780,3090,7014,44%,589,1565,38%,2501,5449,46%,8288,-3884,22%,10-11,10-11 Minnesota Timberwolves,19.08536585,66.45121951,85.53658537
2011,2010-11,Dallas Mavericks,82,19705,3069,6463,48%,645,1768,37%,2424,4695,52%,8220,-2927,27%,10-11,10-11 Dallas Mavericks,21.56097561,57.25609756,78.81707317
2011,2010-11,Memphis Grizzlies,82,19880,3200,6801,47%,309,926,33%,2891,5875,49%,8195,-4949,14%,10-11,10-11 Memphis Grizzlies,11.29268293,71.64634146,82.93902439
2011,2010-11,Indiana Pacers,82,19780,3003,6787,44%,585,1653,35%,2418,5134,47%,8183,-3481,24%,10-11,10-11 Indiana Pacers,20.15853659,62.6097561,82.76829268
2011,2010-11,Utah Jazz,82,19880,3064,6590,47%,435,1256,35%,2629,5334,49%,8153,-4078,19%,10-11,10-11 Utah Jazz,15.31707317,65.04878049,80.36585366
2011,2010-11,Sacramento Kings,82,19855,3134,6979,45%,428,1277,34%,2706,5702,48%,8151,-4425,18%,10-11,10-11 Sacramento Kings,15.57317073,69.53658537,85.1097561
2011,2010-11,Orlando Magic,82,19830,2956,6411,46%,770,2103,37%,2186,4308,51%,8135,-2205,33%,10-11,10-11 Orlando Magic,25.64634146,52.53658537,78.18292683
2011,2010-11,Toronto Raptors,82,19780,3144,6755,47%,345,1091,32%,2799,5664,49%,8124,-4573,16%,10-11,10-11 Toronto Raptors,13.30487805,69.07317073,82.37804878
2011,2010-11,Philadelphia 76ers,82,19930,3125,6776,46%,443,1248,36%,2682,5528,49%,8119,-4280,18%,10-11,10-11 Philadelphia 76ers,15.2195122,67.41463415,82.63414634
2011,2010-11,Los Angeles Clippers,82,19855,3015,6594,46%,513,1519,34%,2502,5075,49%,8089,-3556,23%,10-11,10-11 Los Angeles Clippers,18.52439024,61.8902439,80.41463415
2011,2010-11,Chicago Bulls,82,19830,3042,6587,46%,511,1415,36%,2531,5172,49%,8087,-3757,21%,10-11,10-11 Chicago Bulls,17.25609756,63.07317073,80.32926829
2011,2010-11,Washington Wizards,82,19930,3048,6888,44%,392,1182,33%,2656,5706,47%,7977,-4524,17%,10-11,10-11 Washington Wizards,14.41463415,69.58536585,84
2011,2010-11,Detroit Pistons,82,19880,3056,6647,46%,472,1256,38%,2584,5391,48%,7951,-4135,19%,10-11,10-11 Detroit Pistons,15.31707317,65.74390244,81.06097561
2011,2010-11,Boston Celtics,82,19780,3023,6219,49%,408,1119,37%,2615,5100,51%,7913,-3981,18%,10-11,10-11 Boston Celtics,13.64634146,62.19512195,75.84146341
2011,2010-11,Portland Trail Blazers,82,19805,2951,6599,45%,518,1503,35%,2433,5096,48%,7896,-3593,23%,10-11,10-11 Portland Trail Blazers,18.32926829,62.14634146,80.47560976
2011,2010-11,Cleveland Cavaliers,82,19755,2886,6647,43%,509,1489,34%,2377,5158,46%,7827,-3669,22%,10-11,10-11 Cleveland Cavaliers,18.15853659,62.90243902,81.06097561
2011,2010-11,Atlanta Hawks,82,19730,2971,6429,46%,502,1427,35%,2469,5002,49%,7790,-3575,22%,10-11,10-11 Atlanta Hawks,17.40243902,61,78.40243902
2011,2010-11,New Orleans Hornets,82,19830,2944,6416,46%,444,1232,36%,2500,5184,48%,7784,-3952,19%,10-11,10-11 New Orleans Hornets,15.02439024,63.2195122,78.24390244
2011,2010-11,New Jersey Nets,82,20005,2918,6638,44%,459,1337,34%,2459,5301,46%,7722,-3964,20%,10-11,10-11 New Jersey Nets,16.30487805,64.64634146,80.95121951
2011,2010-11,Charlotte Bobcats,82,19805,2873,6365,45%,393,1203,33%,2480,5162,48%,7650,-3959,19%,10-11,10-11 Charlotte Bobcats,14.67073171,62.95121951,77.62195122
2011,2010-11,Milwaukee Bucks,82,19830,2814,6544,43%,483,1414,34%,2331,5130,45%,7534,-3716,22%,10-11,10-11 Milwaukee Bucks,17.24390244,62.56097561,79.80487805
2010,2009-10,Phoenix Suns,82,19730,3339,6788,49%,730,1770,41%,2609,5018,52%,9039,-3248,26%,09-10,09-10 Phoenix Suns,21.58536585,61.19512195,82.7804878
2010,2009-10,Golden State Warriors,82,19730,3329,7094,47%,633,1687,38%,2696,5407,50%,8922,-3720,24%,09-10,09-10 Golden State Warriors,20.57317073,65.93902439,86.51219512
2010,2009-10,Denver Nuggets,82,19780,3124,6678,47%,544,1517,36%,2580,5161,50%,8729,-3644,23%,09-10,09-10 Denver Nuggets,18.5,62.93902439,81.43902439
2010,2009-10,Utah Jazz,82,19755,3227,6575,49%,439,1207,36%,2788,5368,52%,8547,-4161,18%,09-10,09-10 Utah Jazz,14.7195122,65.46341463,80.18292683
2010,2009-10,Toronto Raptors,82,19780,3199,6631,48%,518,1397,37%,2681,5234,51%,8534,-3837,21%,09-10,09-10 Toronto Raptors,17.03658537,63.82926829,80.86585366
2010,2009-10,Orlando Magic,82,19730,3005,6394,47%,841,2241,38%,2164,4153,52%,8426,-1912,35%,09-10,09-10 Orlando Magic,27.32926829,50.64634146,77.97560976
2010,2009-10,Memphis Grizzlies,82,19905,3223,6875,47%,344,1020,34%,2879,5855,49%,8404,-4835,15%,09-10,09-10 Memphis Grizzlies,12.43902439,71.40243902,83.84146341
2010,2009-10,Houston Rockets,82,19905,3094,6923,45%,646,1838,35%,2448,5085,48%,8395,-3247,27%,09-10,09-10 Houston Rockets,22.41463415,62.01219512,84.42682927
2010,2009-10,New York Knicks,82,19880,3127,6876,46%,743,2145,35%,2384,4731,50%,8373,-2586,31%,09-10,09-10 New York Knicks,26.15853659,57.69512195,83.85365854
2010,2009-10,Cleveland Cavaliers,82,19780,3101,6391,49%,602,1582,38%,2499,4809,52%,8373,-3227,25%,09-10,09-10 Cleveland Cavaliers,19.29268293,58.64634146,77.93902439
2010,2009-10,Dallas Mavericks,82,19880,3140,6760,46%,558,1498,37%,2582,5262,49%,8364,-3764,22%,09-10,09-10 Dallas Mavericks,18.26829268,64.17073171,82.43902439
2010,2009-10,Los Angeles Lakers,82,19830,3144,6875,46%,532,1562,34%,2612,5313,49%,8339,-3751,23%,09-10,09-10 Los Angeles Lakers,19.04878049,64.79268293,83.84146341
2010,2009-10,Atlanta Hawks,82,19855,3181,6801,47%,524,1455,36%,2657,5346,50%,8338,-3891,21%,09-10,09-10 Atlanta Hawks,17.74390244,65.19512195,82.93902439
2010,2009-10,Oklahoma City Thunder,82,19805,3063,6629,46%,418,1229,34%,2645,5400,49%,8322,-4171,19%,09-10,09-10 Oklahoma City Thunder,14.98780488,65.85365854,80.84146341
2010,2009-10,San Antonio Spurs,82,19780,3150,6659,47%,554,1547,36%,2596,5112,51%,8312,-3565,23%,09-10,09-10 San Antonio Spurs,18.86585366,62.34146341,81.20731707
2010,2009-10,Indiana Pacers,82,19705,3020,6823,44%,659,1896,35%,2361,4927,48%,8263,-3031,28%,09-10,09-10 Indiana Pacers,23.12195122,60.08536585,83.20731707
2010,2009-10,New Orleans Hornets,82,19830,3178,6842,46%,571,1572,36%,2607,5270,50%,8220,-3698,23%,09-10,09-10 New Orleans Hornets,19.17073171,64.26829268,83.43902439
2010,2009-10,Sacramento Kings,82,19880,3144,6895,46%,482,1383,35%,2662,5512,48%,8200,-4129,20%,09-10,09-10 Sacramento Kings,16.86585366,67.2195122,84.08536585
2010,2009-10,Boston Celtics,82,19780,3039,6294,48%,499,1433,35%,2540,4861,52%,8136,-3428,23%,09-10,09-10 Boston Celtics,17.47560976,59.2804878,76.75609756
2010,2009-10,Minnesota Timberwolves,82,19780,3106,6923,45%,403,1181,34%,2703,5742,47%,8051,-4561,17%,09-10,09-10 Minnesota Timberwolves,14.40243902,70.02439024,84.42682927
2010,2009-10,Portland Trail Blazers,82,19855,2974,6453,46%,491,1388,35%,2483,5065,49%,8045,-3677,22%,09-10,09-10 Portland Trail Blazers,16.92682927,61.76829268,78.69512195
2010,2009-10,Philadelphia 76ers,82,19805,3087,6706,46%,474,1381,34%,2613,5325,49%,8014,-3944,21%,09-10,09-10 Philadelphia 76ers,16.84146341,64.93902439,81.7804878
2010,2009-10,Milwaukee Bucks,82,19980,3050,6998,44%,645,1813,36%,2405,5185,46%,8009,-3372,26%,09-10,09-10 Milwaukee Bucks,22.1097561,63.23170732,85.34146341
2010,2009-10,Chicago Bulls,82,19905,3081,6825,45%,352,1066,33%,2729,5759,47%,7993,-4693,16%,09-10,09-10 Chicago Bulls,13,70.23170732,83.23170732
2010,2009-10,Miami Heat,82,19880,2984,6518,46%,494,1426,35%,2490,5092,49%,7914,-3666,22%,09-10,09-10 Miami Heat,17.3902439,62.09756098,79.48780488
2010,2009-10,Washington Wizards,82,19830,3008,6700,45%,432,1225,35%,2576,5475,47%,7892,-4250,18%,09-10,09-10 Washington Wizards,14.93902439,66.76829268,81.70731707
2010,2009-10,Los Angeles Clippers,82,19705,3002,6601,46%,483,1457,33%,2519,5144,49%,7849,-3687,22%,09-10,09-10 Los Angeles Clippers,17.76829268,62.73170732,80.5
2010,2009-10,Charlotte Bobcats,82,19880,2858,6306,45%,460,1331,35%,2398,4975,48%,7813,-3644,21%,09-10,09-10 Charlotte Bobcats,16.23170732,60.67073171,76.90243902
2010,2009-10,Detroit Pistons,82,19780,2940,6602,45%,374,1190,31%,2566,5412,47%,7709,-4222,18%,09-10,09-10 Detroit Pistons,14.51219512,66,80.51219512
2010,2009-10,New Jersey Nets,82,19780,2813,6554,43%,377,1185,32%,2436,5369,45%,7575,-4184,18%,09-10,09-10 New Jersey Nets,14.45121951,65.47560976,79.92682927
2009,2008-09,Phoenix Suns,82,19755,3373,6695,50%,553,1445,38%,2820,5250,54%,8974,-3805,22%,08-09,08-09 Phoenix Suns,17.62195122,64.02439024,81.64634146
2009,2008-09,Golden State Warriors,82,19880,3231,7055,46%,550,1475,37%,2681,5580,48%,8905,-4105,21%,08-09,08-09 Golden State Warriors,17.98780488,68.04878049,86.03658537
2009,2008-09,Los Angeles Lakers,82,19780,3307,6981,47%,547,1516,36%,2760,5465,51%,8768,-3949,22%,08-09,08-09 Los Angeles Lakers,18.48780488,66.64634146,85.13414634
2009,2008-09,New York Knicks,82,19805,3157,7091,45%,823,2284,36%,2334,4807,49%,8627,-2523,32%,08-09,08-09 New York Knicks,27.85365854,58.62195122,86.47560976
2009,2008-09,Indiana Pacers,82,19830,3220,7080,46%,652,1725,38%,2568,5355,48%,8617,-3630,24%,08-09,08-09 Indiana Pacers,21.03658537,65.30487805,86.34146341
2009,2008-09,Denver Nuggets,82,19730,3058,6510,47%,548,1477,37%,2510,5033,50%,8555,-3556,23%,08-09,08-09 Denver Nuggets,18.01219512,61.37804878,79.3902439
2009,2008-09,Utah Jazz,82,19880,3143,6623,48%,392,1122,35%,2751,5501,50%,8492,-4379,17%,08-09,08-09 Utah Jazz,13.68292683,67.08536585,80.76829268
2009,2008-09,Chicago Bulls,82,19930,3126,6846,46%,493,1293,38%,2633,5553,47%,8378,-4260,19%,08-09,08-09 Chicago Bulls,15.76829268,67.7195122,83.48780488
2009,2008-09,Dallas Mavericks,82,19805,3128,6770,46%,571,1632,35%,2557,5138,50%,8343,-3506,24%,08-09,08-09 Dallas Mavericks,19.90243902,62.65853659,82.56097561
2009,2008-09,Orlando Magic,82,19730,2929,6416,46%,817,2147,38%,2112,4269,50%,8286,-2122,33%,08-09,08-09 Orlando Magic,26.18292683,52.06097561,78.24390244
2009,2008-09,Boston Celtics,82,19880,3075,6333,49%,538,1355,40%,2537,4978,51%,8275,-3623,21%,08-09,08-09 Boston Celtics,16.52439024,60.70731707,77.23170732
2009,2008-09,Sacramento Kings,82,19905,2990,6685,45%,586,1594,37%,2404,5091,47%,8248,-3497,24%,08-09,08-09 Sacramento Kings,19.43902439,62.08536585,81.52439024
2009,2008-09,Cleveland Cavaliers,82,19780,3022,6454,47%,656,1670,39%,2366,4784,50%,8223,-3114,26%,08-09,08-09 Cleveland Cavaliers,20.36585366,58.34146341,78.70731707
2009,2008-09,Portland Trail Blazers,82,19830,3018,6494,47%,596,1555,38%,2422,4939,49%,8153,-3384,24%,08-09,08-09 Portland Trail Blazers,18.96341463,60.23170732,79.19512195
2009,2008-09,Milwaukee Bucks,82,19780,3009,6755,45%,511,1408,36%,2498,5347,47%,8142,-3939,21%,08-09,08-09 Milwaukee Bucks,17.17073171,65.20731707,82.37804878
2009,2008-09,Toronto Raptors,82,19805,3054,6673,46%,479,1289,37%,2575,5384,48%,8121,-4095,19%,08-09,08-09 Toronto Raptors,15.7195122,65.65853659,81.37804878
2009,2008-09,Houston Rockets,82,19805,2959,6526,45%,621,1656,38%,2338,4870,48%,8070,-3214,25%,08-09,08-09 Houston Rockets,20.19512195,59.3902439,79.58536585
2009,2008-09,Miami Heat,82,19955,3034,6646,46%,582,1631,36%,2452,5015,49%,8061,-3384,25%,08-09,08-09 Miami Heat,19.8902439,61.15853659,81.04878049
2009,2008-09,Atlanta Hawks,82,19705,2956,6451,46%,597,1633,37%,2359,4818,49%,8046,-3185,25%,08-09,08-09 Atlanta Hawks,19.91463415,58.75609756,78.67073171
2009,2008-09,New Jersey Nets,82,19830,2925,6536,45%,652,1735,38%,2273,4801,47%,8044,-3066,27%,08-09,08-09 New Jersey Nets,21.15853659,58.54878049,79.70731707
2009,2008-09,Minnesota Timberwolves,82,19805,2986,6766,44%,543,1539,35%,2443,5227,47%,8019,-3688,23%,08-09,08-09 Minnesota Timberwolves,18.76829268,63.74390244,82.51219512
2009,2008-09,Philadelphia 76ers,82,19755,2997,6532,46%,341,1072,32%,2656,5460,49%,7987,-4388,16%,08-09,08-09 Philadelphia 76ers,13.07317073,66.58536585,79.65853659
2009,2008-09,San Antonio Spurs,82,19905,3042,6534,47%,625,1620,39%,2417,4914,49%,7958,-3294,25%,08-09,08-09 San Antonio Spurs,19.75609756,59.92682927,79.68292683
2009,2008-09,Oklahoma City Thunder,82,19805,2999,6716,45%,328,949,35%,2671,5767,46%,7952,-4818,14%,08-09,08-09 Oklahoma City Thunder,11.57317073,70.32926829,81.90243902
2009,2008-09,Washington Wizards,82,19705,2994,6655,45%,395,1198,33%,2599,5457,48%,7877,-4259,18%,08-09,08-09 Washington Wizards,14.6097561,66.54878049,81.15853659
2009,2008-09,New Orleans Hornets,82,19755,2911,6366,46%,556,1526,36%,2355,4840,49%,7857,-3314,24%,08-09,08-09 New Orleans Hornets,18.6097561,59.02439024,77.63414634
2009,2008-09,Los Angeles Clippers,82,19880,2955,6696,44%,535,1513,35%,2420,5183,47%,7799,-3670,23%,08-09,08-09 Los Angeles Clippers,18.45121951,63.20731707,81.65853659
2009,2008-09,Detroit Pistons,82,19905,2981,6559,45%,377,1079,35%,2604,5480,48%,7727,-4401,16%,08-09,08-09 Detroit Pistons,13.15853659,66.82926829,79.98780488
2009,2008-09,Memphis Grizzlies,82,19805,2865,6311,45%,398,1106,36%,2467,5205,47%,7698,-4099,18%,08-09,08-09 Memphis Grizzlies,13.48780488,63.47560976,76.96341463
2009,2008-09,Charlotte Bobcats,82,19930,2866,6299,46%,490,1339,37%,2376,4960,48%,7677,-3621,21%,08-09,08-09 Charlotte Bobcats,16.32926829,60.48780488,76.81707317
2008,2007-08,Golden State Warriors,82,19780,3403,7406,46%,761,2185,35%,2642,5221,51%,9105,-3036,30%,07-08,07-08 Golden State Warriors,26.64634146,63.67073171,90.31707317
2008,2007-08,Denver Nuggets,82,19855,3307,7038,47%,569,1605,36%,2738,5433,50%,9074,-3828,23%,07-08,07-08 Denver Nuggets,19.57317073,66.25609756,85.82926829
2008,2007-08,Phoenix Suns,82,19780,3392,6782,50%,694,1764,39%,2698,5018,54%,9026,-3254,26%,07-08,07-08 Phoenix Suns,21.51219512,61.19512195,82.70731707
2008,2007-08,Los Angeles Lakers,82,19780,3248,6818,48%,662,1751,38%,2586,5067,51%,8904,-3316,26%,07-08,07-08 Los Angeles Lakers,21.35365854,61.79268293,83.14634146
2008,2007-08,Utah Jazz,82,19705,3279,6592,50%,407,1095,37%,2872,5497,52%,8710,-4402,17%,07-08,07-08 Utah Jazz,13.35365854,67.03658537,80.3902439
2008,2007-08,Orlando Magic,82,19780,3058,6446,47%,801,2074,39%,2257,4372,52%,8567,-2298,32%,07-08,07-08 Orlando Magic,25.29268293,53.31707317,78.6097561
2008,2007-08,Indiana Pacers,82,19755,3102,6993,44%,755,2021,37%,2347,4972,47%,8527,-2951,29%,07-08,07-08 Indiana Pacers,24.64634146,60.63414634,85.2804878
2008,2007-08,Sacramento Kings,82,19830,3043,6558,46%,510,1367,37%,2533,5191,49%,8408,-3824,21%,07-08,07-08 Sacramento Kings,16.67073171,63.30487805,79.97560976
2008,2007-08,New Orleans Hornets,82,19805,3164,6796,47%,630,1621,39%,2534,5175,49%,8270,-3554,24%,07-08,07-08 New Orleans Hornets,19.76829268,63.1097561,82.87804878
2008,2007-08,Memphis Grizzlies,82,19805,3060,6737,45%,620,1779,35%,2440,4958,49%,8257,-3179,26%,07-08,07-08 Memphis Grizzlies,21.69512195,60.46341463,82.15853659
2008,2007-08,Boston Celtics,82,19755,2986,6286,48%,596,1564,38%,2390,4722,51%,8245,-3158,25%,07-08,07-08 Boston Celtics,19.07317073,57.58536585,76.65853659
2008,2007-08,Dallas Mavericks,82,19730,3025,6515,46%,494,1403,35%,2531,5112,50%,8234,-3709,22%,07-08,07-08 Dallas Mavericks,17.1097561,62.34146341,79.45121951
2008,2007-08,Toronto Raptors,82,19830,3148,6726,47%,572,1459,39%,2576,5267,49%,8215,-3808,22%,07-08,07-08 Toronto Raptors,17.79268293,64.23170732,82.02439024
2008,2007-08,Washington Wizards,82,19905,2986,6695,45%,575,1614,36%,2411,5081,48%,8104,-3467,24%,07-08,07-08 Washington Wizards,19.68292683,61.96341463,81.64634146
2008,2007-08,Atlanta Hawks,82,19855,2975,6552,45%,384,1078,36%,2591,5474,47%,8054,-4396,16%,07-08,07-08 Atlanta Hawks,13.14634146,66.75609756,79.90243902
2008,2007-08,Seattle SuperSonics,82,19830,3125,7032,44%,313,939,33%,2812,6093,46%,7999,-5154,13%,07-08,07-08 Seattle SuperSonics,11.45121951,74.30487805,85.75609756
2008,2007-08,Detroit Pistons,82,19730,2999,6551,46%,487,1330,37%,2512,5221,48%,7992,-3891,20%,07-08,07-08 Detroit Pistons,16.2195122,63.67073171,79.8902439
2008,2007-08,Chicago Bulls,82,19805,2987,6861,44%,474,1305,36%,2513,5556,45%,7981,-4251,19%,07-08,07-08 Chicago Bulls,15.91463415,67.75609756,83.67073171
2008,2007-08,Charlotte Bobcats,82,19880,2960,6554,45%,529,1443,37%,2431,5111,48%,7959,-3668,22%,07-08,07-08 Charlotte Bobcats,17.59756098,62.32926829,79.92682927
2008,2007-08,Milwaukee Bucks,82,19855,3026,6745,45%,452,1313,34%,2574,5432,47%,7956,-4119,19%,07-08,07-08 Milwaukee Bucks,16.01219512,66.24390244,82.25609756
2008,2007-08,New York Knicks,82,19880,2967,6757,44%,490,1454,34%,2477,5303,47%,7948,-3849,22%,07-08,07-08 New York Knicks,17.73170732,64.67073171,82.40243902
2008,2007-08,Houston Rockets,82,19730,3003,6698,45%,583,1707,34%,2420,4991,49%,7931,-3284,25%,07-08,07-08 Houston Rockets,20.81707317,60.86585366,81.68292683
2008,2007-08,Philadelphia 76ers,82,19755,3056,6648,46%,302,952,32%,2754,5696,48%,7923,-4744,14%,07-08,07-08 Philadelphia 76ers,11.6097561,69.46341463,81.07317073
2008,2007-08,Cleveland Cavaliers,82,19855,2937,6697,44%,552,1544,36%,2385,5153,46%,7903,-3609,23%,07-08,07-08 Cleveland Cavaliers,18.82926829,62.84146341,81.67073171
2008,2007-08,New Jersey Nets,82,19830,2856,6450,44%,498,1430,35%,2358,5020,47%,7857,-3590,22%,07-08,07-08 New Jersey Nets,17.43902439,61.2195122,78.65853659
2008,2007-08,Minnesota Timberwolves,82,19730,3076,6817,45%,441,1259,35%,2635,5558,47%,7839,-4299,18%,07-08,07-08 Minnesota Timberwolves,15.35365854,67.7804878,83.13414634
2008,2007-08,Portland Trail Blazers,82,19905,2935,6546,45%,538,1426,38%,2397,5120,47%,7820,-3694,22%,07-08,07-08 Portland Trail Blazers,17.3902439,62.43902439,79.82926829
2008,2007-08,San Antonio Spurs,82,19730,2938,6424,46%,594,1610,37%,2344,4814,49%,7820,-3204,25%,07-08,07-08 San Antonio Spurs,19.63414634,58.70731707,78.34146341
2008,2007-08,Los Angeles Clippers,82,19805,2820,6445,44%,350,1079,32%,2470,5366,46%,7692,-4287,17%,07-08,07-08 Los Angeles Clippers,13.15853659,65.43902439,78.59756098
2008,2007-08,Miami Heat,82,19830,2808,6336,44%,491,1373,36%,2317,4963,47%,7491,-3590,22%,07-08,07-08 Miami Heat,16.74390244,60.52439024,77.26829268
2007,2006-07,Phoenix Suns,82,19905,3388,6855,49%,785,1965,40%,2603,4890,53%,9037,-2925,29%,06-07,06-07 Phoenix Suns,23.96341463,59.63414634,83.59756098
2007,2006-07,Golden State Warriors,82,19755,3261,7048,46%,700,1967,36%,2561,5081,50%,8737,-3114,28%,06-07,06-07 Golden State Warriors,23.98780488,61.96341463,85.95121951
2007,2006-07,Denver Nuggets,82,19780,3164,6805,47%,484,1440,34%,2680,5365,50%,8639,-3925,21%,06-07,06-07 Denver Nuggets,17.56097561,65.42682927,82.98780488
2007,2006-07,Washington Wizards,82,19830,3070,6820,45%,561,1614,35%,2509,5206,48%,8556,-3592,24%,06-07,06-07 Washington Wizards,19.68292683,63.48780488,83.17073171
2007,2006-07,Los Angeles Lakers,82,20030,3103,6664,47%,608,1724,35%,2495,4940,51%,8474,-3216,26%,06-07,06-07 Los Angeles Lakers,21.02439024,60.24390244,81.26829268
2007,2006-07,Memphis Grizzlies,82,19980,2998,6448,47%,500,1362,37%,2498,5086,49%,8331,-3724,21%,06-07,06-07 Memphis Grizzlies,16.6097561,62.02439024,78.63414634
2007,2006-07,Utah Jazz,82,19805,3069,6471,47%,354,1056,34%,2715,5415,50%,8322,-4359,16%,06-07,06-07 Utah Jazz,12.87804878,66.03658537,78.91463415
2007,2006-07,Sacramento Kings,82,19805,2941,6532,45%,530,1513,35%,2411,5019,48%,8303,-3506,23%,06-07,06-07 Sacramento Kings,18.45121951,61.20731707,79.65853659
2007,2006-07,Dallas Mavericks,82,19755,3010,6442,47%,535,1404,38%,2475,5038,49%,8201,-3634,22%,06-07,06-07 Dallas Mavericks,17.12195122,61.43902439,78.56097561
2007,2006-07,Milwaukee Bucks,82,19855,3121,6714,47%,524,1472,36%,2597,5242,50%,8172,-3770,22%,06-07,06-07 Milwaukee Bucks,17.95121951,63.92682927,81.87804878
2007,2006-07,Toronto Raptors,82,19755,3032,6547,46%,531,1464,36%,2501,5083,49%,8157,-3619,22%,06-07,06-07 Toronto Raptors,17.85365854,61.98780488,79.84146341
2007,2006-07,Seattle SuperSonics,82,19830,3047,6628,46%,525,1451,36%,2522,5177,49%,8130,-3726,22%,06-07,06-07 Seattle SuperSonics,17.69512195,63.13414634,80.82926829
2007,2006-07,Chicago Bulls,82,19780,3046,6663,46%,480,1237,39%,2566,5426,47%,8100,-4189,19%,06-07,06-07 Chicago Bulls,15.08536585,66.17073171,81.25609756
2007,2006-07,San Antonio Spurs,82,19780,2999,6328,47%,595,1561,38%,2404,4767,50%,8079,-3206,25%,06-07,06-07 San Antonio Spurs,19.03658537,58.13414634,77.17073171
2007,2006-07,New Jersey Nets,82,19880,2913,6379,46%,609,1676,36%,2304,4703,49%,8001,-3027,26%,06-07,06-07 New Jersey Nets,20.43902439,57.35365854,77.79268293
2007,2006-07,New York Knicks,82,20005,2903,6356,46%,474,1370,35%,2429,4986,49%,7994,-3616,22%,06-07,06-07 New York Knicks,16.70731707,60.80487805,77.51219512
2007,2006-07,Houston Rockets,82,19855,2906,6528,45%,705,1893,37%,2201,4635,48%,7953,-2742,29%,06-07,06-07 Houston Rockets,23.08536585,56.52439024,79.6097561
2007,2006-07,Charlotte Bobcats,82,20005,2960,6643,45%,457,1280,36%,2503,5363,47%,7945,-4083,19%,06-07,06-07 Charlotte Bobcats,15.6097561,65.40243902,81.01219512
2007,2006-07,Cleveland Cavaliers,82,19880,2978,6658,45%,494,1404,35%,2484,5254,47%,7934,-3850,21%,06-07,06-07 Cleveland Cavaliers,17.12195122,64.07317073,81.19512195
2007,2006-07,Minnesota Timberwolves,82,20005,2997,6503,46%,384,1089,35%,2613,5414,48%,7877,-4325,17%,06-07,06-07 Minnesota Timberwolves,13.2804878,66.02439024,79.30487805
2007,2006-07,Detroit Pistons,82,19880,2942,6484,45%,449,1305,34%,2493,5179,48%,7872,-3874,20%,06-07,06-07 Detroit Pistons,15.91463415,63.15853659,79.07317073
2007,2006-07,Boston Celtics,82,19855,2858,6454,44%,471,1283,37%,2387,5171,46%,7857,-3888,20%,06-07,06-07 Boston Celtics,15.64634146,63.06097561,78.70731707
2007,2006-07,Los Angeles Clippers,82,19730,2880,6318,46%,314,903,35%,2566,5415,47%,7843,-4512,14%,06-07,06-07 Los Angeles Clippers,11.01219512,66.03658537,77.04878049
2007,2006-07,Indiana Pacers,82,19780,2872,6561,44%,481,1389,35%,2391,5172,46%,7840,-3783,21%,06-07,06-07 Indiana Pacers,16.93902439,63.07317073,80.01219512
2007,2006-07,New Orleans/Oklahoma City Hornets,82,19880,2971,6674,45%,455,1256,36%,2516,5418,46%,7833,-4162,19%,06-07,06-07 New Orleans/Oklahoma City Hornets,15.31707317,66.07317073,81.3902439
2007,2006-07,Philadelphia 76ers,82,19880,2932,6408,46%,284,823,35%,2648,5585,47%,7785,-4762,13%,06-07,06-07 Philadelphia 76ers,10.03658537,68.1097561,78.14634146
2007,2006-07,Orlando Magic,82,19780,2875,6090,47%,342,962,36%,2533,5128,49%,7771,-4166,16%,06-07,06-07 Orlando Magic,11.73170732,62.53658537,74.26829268
2007,2006-07,Miami Heat,82,19855,2919,6288,46%,528,1539,34%,2391,4749,50%,7759,-3210,24%,06-07,06-07 Miami Heat,18.76829268,57.91463415,76.68292683
2007,2006-07,Portland Trail Blazers,82,19955,2874,6392,45%,426,1232,35%,2448,5160,47%,7717,-3928,19%,06-07,06-07 Portland Trail Blazers,15.02439024,62.92682927,77.95121951
2007,2006-07,Atlanta Hawks,82,19880,2831,6372,44%,341,1038,33%,2490,5334,47%,7680,-4296,16%,06-07,06-07 Atlanta Hawks,12.65853659,65.04878049,77.70731707
2006,2005-06,Phoenix Suns,82,19955,3430,7167,48%,837,2097,40%,2593,5070,51%,8886,-2973,29%,05-06,05-06 Phoenix Suns,25.57317073,61.82926829,87.40243902
2006,2005-06,Seattle SuperSonics,82,19830,3077,6711,46%,605,1631,37%,2472,5080,49%,8411,-3449,24%,05-06,05-06 Seattle SuperSonics,19.8902439,61.95121951,81.84146341
2006,2005-06,Washington Wizards,82,19830,2975,6656,45%,497,1394,36%,2478,5262,47%,8336,-3868,21%,05-06,05-06 Washington Wizards,17,64.17073171,81.17073171
2006,2005-06,Toronto Raptors,82,19955,3013,6639,45%,608,1620,38%,2405,5019,48%,8287,-3399,24%,05-06,05-06 Toronto Raptors,19.75609756,61.20731707,80.96341463
2006,2005-06,Denver Nuggets,82,19930,3078,6672,46%,350,1076,33%,2728,5596,49%,8227,-4520,16%,05-06,05-06 Denver Nuggets,13.12195122,68.24390244,81.36585366
2006,2005-06,Miami Heat,82,19755,3039,6355,48%,497,1441,35%,2542,4914,52%,8191,-3473,23%,05-06,05-06 Miami Heat,17.57317073,59.92682927,77.5
2006,2005-06,Los Angeles Lakers,82,19855,2992,6607,45%,552,1583,35%,2440,5024,49%,8154,-3441,24%,05-06,05-06 Los Angeles Lakers,19.30487805,61.26829268,80.57317073
2006,2005-06,Philadelphia 76ers,82,19905,3001,6546,46%,375,1031,36%,2626,5515,48%,8147,-4484,16%,05-06,05-06 Philadelphia 76ers,12.57317073,67.25609756,79.82926829
2006,2005-06,Dallas Mavericks,82,19880,2948,6375,46%,416,1113,37%,2532,5262,48%,8130,-4149,17%,05-06,05-06 Dallas Mavericks,13.57317073,64.17073171,77.74390244
2006,2005-06,Sacramento Kings,82,19830,2954,6500,45%,494,1408,35%,2460,5092,48%,8106,-3684,22%,05-06,05-06 Sacramento Kings,17.17073171,62.09756098,79.26829268
2006,2005-06,Golden State Warriors,82,19830,2939,6785,43%,625,1832,34%,2314,4953,47%,8076,-3121,27%,05-06,05-06 Golden State Warriors,22.34146341,60.40243902,82.74390244
2006,2005-06,Boston Celtics,82,19880,2951,6322,47%,467,1290,36%,2484,5032,49%,8033,-3742,20%,05-06,05-06 Boston Celtics,15.73170732,61.36585366,77.09756098
2006,2005-06,Milwaukee Bucks,82,19855,2976,6566,45%,507,1335,38%,2469,5231,47%,8020,-3896,20%,05-06,05-06 Milwaukee Bucks,16.2804878,63.79268293,80.07317073
2006,2005-06,Chicago Bulls,82,19905,3004,6737,45%,560,1477,38%,2444,5260,47%,8020,-3783,22%,05-06,05-06 Chicago Bulls,18.01219512,64.14634146,82.15853659
2006,2005-06,Cleveland Cavaliers,82,19830,2908,6412,45%,497,1465,34%,2411,4947,49%,8002,-3482,23%,05-06,05-06 Cleveland Cavaliers,17.86585366,60.32926829,78.19512195
2006,2005-06,Atlanta Hawks,82,19880,2946,6496,45%,424,1154,37%,2522,5342,47%,7972,-4188,18%,05-06,05-06 Atlanta Hawks,14.07317073,65.14634146,79.2195122
2006,2005-06,Los Angeles Clippers,82,19805,2993,6443,47%,290,843,34%,2703,5600,48%,7970,-4757,13%,05-06,05-06 Los Angeles Clippers,10.2804878,68.29268293,78.57317073
2006,2005-06,Charlotte Bobcats,82,19905,2961,6843,43%,428,1261,34%,2533,5582,45%,7943,-4321,18%,05-06,05-06 Charlotte Bobcats,15.37804878,68.07317073,83.45121951
2006,2005-06,Detroit Pistons,82,19830,2983,6558,46%,557,1451,38%,2426,5107,48%,7941,-3656,22%,05-06,05-06 Detroit Pistons,17.69512195,62.2804878,79.97560976
2006,2005-06,New York Knicks,82,19930,2822,6206,46%,320,884,36%,2502,5322,47%,7842,-4438,14%,05-06,05-06 New York Knicks,10.7804878,64.90243902,75.68292683
2006,2005-06,San Antonio Spurs,82,19805,2993,6342,47%,524,1362,39%,2469,4980,50%,7837,-3618,21%,05-06,05-06 San Antonio Spurs,16.6097561,60.73170732,77.34146341
2006,2005-06,Orlando Magic,82,19905,2911,6167,47%,299,796,38%,2612,5371,49%,7784,-4575,13%,05-06,05-06 Orlando Magic,9.707317073,65.5,75.20731707
2006,2005-06,Indiana Pacers,82,19730,2786,6274,44%,536,1536,35%,2250,4738,48%,7699,-3202,24%,05-06,05-06 Indiana Pacers,18.73170732,57.7804878,76.51219512
2006,2005-06,New Jersey Nets,82,19780,2778,6317,44%,477,1447,33%,2301,4870,47%,7691,-3423,23%,05-06,05-06 New Jersey Nets,17.64634146,59.3902439,77.03658537
2006,2005-06,New Orleans/Oklahoma City Hornets,82,19805,2831,6428,44%,300,885,34%,2531,5543,46%,7611,-4658,14%,05-06,05-06 New Orleans/Oklahoma City Hornets,10.79268293,67.59756098,78.3902439
2006,2005-06,Utah Jazz,82,19880,2744,6207,44%,311,925,34%,2433,5282,46%,7573,-4357,15%,05-06,05-06 Utah Jazz,11.2804878,64.41463415,75.69512195
2006,2005-06,Memphis Grizzlies,82,19855,2746,6125,45%,590,1578,37%,2156,4547,47%,7558,-2969,26%,05-06,05-06 Memphis Grizzlies,19.24390244,55.45121951,74.69512195
2006,2005-06,Minnesota Timberwolves,82,19855,2888,6340,46%,310,942,33%,2578,5398,48%,7522,-4456,15%,05-06,05-06 Minnesota Timberwolves,11.48780488,65.82926829,77.31707317
2006,2005-06,Houston Rockets,82,19830,2708,6252,43%,469,1414,33%,2239,4838,46%,7387,-3424,23%,05-06,05-06 Houston Rockets,17.24390244,59,76.24390244
2006,2005-06,Portland Trail Blazers,82,19730,2791,6267,45%,364,1042,35%,2427,5225,46%,7285,-4183,17%,05-06,05-06 Portland Trail Blazers,12.70731707,63.7195122,76.42682927
2004,2003-04,Dallas Mavericks,82,19805,3322,7230,46%,507,1456,35%,2815,5774,49%,8626,-4318,20%,03-04,03-04 Dallas Mavericks,17.75609756,70.41463415,88.17073171
2004,2003-04,Sacramento Kings,82,19780,3103,6711,46%,601,1498,40%,2502,5213,48%,8433,-3715,22%,03-04,03-04 Sacramento Kings,18.26829268,63.57317073,81.84146341
2004,2003-04,Los Angeles Lakers,82,19855,3028,6676,45%,365,1115,33%,2663,5561,48%,8052,-4446,17%,03-04,03-04 Los Angeles Lakers,13.59756098,67.81707317,81.41463415
2004,2003-04,Milwaukee Bucks,82,19780,2970,6650,45%,401,1145,35%,2569,5505,47%,8039,-4360,17%,03-04,03-04 Milwaukee Bucks,13.96341463,67.13414634,81.09756098
2004,2003-04,Denver Nuggets,82,19730,2993,6763,44%,331,985,34%,2662,5778,46%,7972,-4793,15%,03-04,03-04 Denver Nuggets,12.01219512,70.46341463,82.47560976
2004,2003-04,Seattle SuperSonics,82,19805,2939,6590,45%,723,1936,37%,2216,4654,48%,7964,-2718,29%,03-04,03-04 Seattle SuperSonics,23.6097561,56.75609756,80.36585366
2004,2003-04,Memphis Grizzlies,82,19880,2963,6657,45%,447,1314,34%,2516,5343,47%,7930,-4029,20%,03-04,03-04 Memphis Grizzlies,16.02439024,65.15853659,81.18292683
2004,2003-04,Boston Celtics,82,19705,2843,6415,44%,553,1599,35%,2290,4816,48%,7811,-3217,25%,03-04,03-04 Boston Celtics,19.5,58.73170732,78.23170732
2004,2003-04,Los Angeles Clippers,82,19805,2817,6579,43%,329,1024,32%,2488,5555,45%,7771,-4531,16%,03-04,03-04 Los Angeles Clippers,12.48780488,67.74390244,80.23170732
2004,2003-04,Minnesota Timberwolves,82,19755,3033,6571,46%,326,897,36%,2707,5674,48%,7753,-4777,14%,03-04,03-04 Minnesota Timberwolves,10.93902439,69.19512195,80.13414634
2004,2003-04,Phoenix Suns,82,19730,2958,6671,44%,415,1202,35%,2543,5469,47%,7723,-4267,18%,03-04,03-04 Phoenix Suns,14.65853659,66.69512195,81.35365854
2004,2003-04,Orlando Magic,82,19830,2904,6768,43%,429,1248,34%,2475,5520,45%,7711,-4272,18%,03-04,03-04 Orlando Magic,15.2195122,67.31707317,82.53658537
2004,2003-04,Golden State Warriors,82,19855,2875,6511,44%,429,1283,33%,2446,5228,47%,7649,-3945,20%,03-04,03-04 Golden State Warriors,15.64634146,63.75609756,79.40243902
2004,2003-04,Cleveland Cavaliers,82,19855,2922,6753,43%,247,786,31%,2675,5967,45%,7619,-5181,12%,03-04,03-04 Cleveland Cavaliers,9.585365854,72.76829268,82.35365854
2004,2003-04,Atlanta Hawks,82,19905,2829,6529,43%,419,1249,34%,2410,5280,46%,7611,-4031,19%,03-04,03-04 Atlanta Hawks,15.23170732,64.3902439,79.62195122
2004,2003-04,New York Knicks,82,19880,2881,6513,44%,406,1115,36%,2475,5398,46%,7542,-4283,17%,03-04,03-04 New York Knicks,13.59756098,65.82926829,79.42682927
2004,2003-04,New Orleans Hornets,82,19830,2772,6605,42%,531,1666,32%,2241,4939,45%,7529,-3273,25%,03-04,03-04 New Orleans Hornets,20.31707317,60.23170732,80.54878049
2004,2003-04,Washington Wizards,82,19830,2758,6556,42%,433,1269,34%,2325,5287,44%,7528,-4018,19%,03-04,03-04 Washington Wizards,15.47560976,64.47560976,79.95121951
2004,2003-04,San Antonio Spurs,82,19755,2842,6434,44%,408,1140,36%,2434,5294,46%,7501,-4154,18%,03-04,03-04 San Antonio Spurs,13.90243902,64.56097561,78.46341463
2004,2003-04,Indiana Pacers,82,19805,2753,6322,44%,449,1281,35%,2304,5041,46%,7493,-3760,20%,03-04,03-04 Indiana Pacers,15.62195122,61.47560976,77.09756098
2004,2003-04,Portland Trail Blazers,82,19980,2898,6467,45%,381,1102,35%,2517,5365,47%,7440,-4263,17%,03-04,03-04 Portland Trail Blazers,13.43902439,65.42682927,78.86585366
2004,2003-04,Miami Heat,82,19755,2729,6417,43%,485,1357,36%,2244,5060,44%,7402,-3703,21%,03-04,03-04 Miami Heat,16.54878049,61.70731707,78.25609756
2004,2003-04,New Jersey Nets,82,19705,2813,6372,44%,377,1123,34%,2436,5249,46%,7401,-4126,18%,03-04,03-04 New Jersey Nets,13.69512195,64.01219512,77.70731707
2004,2003-04,Detroit Pistons,82,19780,2747,6314,44%,333,968,34%,2414,5346,45%,7388,-4378,15%,03-04,03-04 Detroit Pistons,11.80487805,65.19512195,77
2004,2003-04,Houston Rockets,82,19930,2738,6195,44%,515,1406,37%,2223,4789,46%,7362,-3383,23%,03-04,03-04 Houston Rockets,17.14634146,58.40243902,75.54878049
2004,2003-04,Chicago Bulls,82,19830,2798,6753,41%,429,1256,34%,2369,5497,43%,7355,-4241,19%,03-04,03-04 Chicago Bulls,15.31707317,67.03658537,82.35365854
2004,2003-04,Utah Jazz,82,19780,2690,6172,44%,252,786,32%,2438,5386,45%,7271,-4600,13%,03-04,03-04 Utah Jazz,9.585365854,65.68292683,75.26829268
2004,2003-04,Philadelphia 76ers,82,19855,2682,6260,43%,339,992,34%,2343,5268,45%,7215,-4276,16%,03-04,03-04 Philadelphia 76ers,12.09756098,64.24390244,76.34146341
2004,2003-04,Toronto Raptors,82,19980,2654,6348,42%,461,1294,36%,2193,5054,43%,7006,-3760,20%,03-04,03-04 Toronto Raptors,15.7804878,61.63414634,77.41463415
2005,2004-05,Phoenix Suns,82,19780,3351,7018,48%,796,2026,39%,2555,4992,51%,9054,-2966,29%,04-05,04-05 Phoenix Suns,24.70731707,60.87804878,85.58536585
2005,2004-05,Sacramento Kings,82,19855,3203,6978,46%,522,1396,37%,2681,5582,48%,8505,-4186,20%,04-05,04-05 Sacramento Kings,17.02439024,68.07317073,85.09756098
2005,2004-05,Dallas Mavericks,82,19730,3058,6691,46%,463,1273,36%,2595,5418,48%,8405,-4145,19%,04-05,04-05 Dallas Mavericks,15.52439024,66.07317073,81.59756098
2005,2004-05,Miami Heat,82,19980,3097,6368,49%,475,1260,38%,2622,5108,51%,8327,-3848,20%,04-05,04-05 Miami Heat,15.36585366,62.29268293,77.65853659
2005,2004-05,Boston Celtics,82,19880,3046,6511,47%,437,1252,35%,2609,5259,50%,8304,-4007,19%,04-05,04-05 Boston Celtics,15.26829268,64.13414634,79.40243902
2005,2004-05,Washington Wizards,82,19780,2966,6794,44%,514,1498,34%,2452,5296,46%,8241,-3798,22%,04-05,04-05 Washington Wizards,18.26829268,64.58536585,82.85365854
2005,2004-05,Toronto Raptors,82,19805,2952,6656,44%,648,1681,39%,2304,4975,46%,8178,-3294,25%,04-05,04-05 Toronto Raptors,20.5,60.67073171,81.17073171
2005,2004-05,Denver Nuggets,82,19755,3038,6615,46%,320,940,34%,2718,5675,48%,8161,-4735,14%,04-05,04-05 Denver Nuggets,11.46341463,69.20731707,80.67073171
2005,2004-05,Orlando Magic,82,19705,3034,6679,45%,320,916,35%,2714,5763,47%,8160,-4847,14%,04-05,04-05 Orlando Magic,11.17073171,70.2804878,81.45121951
2005,2004-05,Philadelphia 76ers,82,19855,2946,6736,44%,505,1453,35%,2441,5283,46%,8128,-3830,22%,04-05,04-05 Philadelphia 76ers,17.7195122,64.42682927,82.14634146
2005,2004-05,Seattle SuperSonics,82,19755,2882,6498,44%,666,1824,37%,2216,4674,47%,8113,-2850,28%,04-05,04-05 Seattle SuperSonics,22.24390244,57,79.24390244
2005,2004-05,Los Angeles Lakers,82,19780,2895,6629,44%,644,1813,36%,2251,4816,47%,8095,-3003,27%,04-05,04-05 Los Angeles Lakers,22.1097561,58.73170732,80.84146341
2005,2004-05,Golden State Warriors,82,19905,3029,7039,43%,624,1774,35%,2405,5265,46%,8094,-3491,25%,04-05,04-05 Golden State Warriors,21.63414634,64.20731707,85.84146341
2005,2004-05,New York Knicks,82,19880,2978,6599,45%,441,1240,36%,2537,5359,47%,7977,-4119,19%,04-05,04-05 New York Knicks,15.12195122,65.35365854,80.47560976
2005,2004-05,Milwaukee Bucks,82,19780,2964,6580,45%,325,925,35%,2639,5655,47%,7973,-4730,14%,04-05,04-05 Milwaukee Bucks,11.2804878,68.96341463,80.24390244
2005,2004-05,Minnesota Timberwolves,82,19755,3045,6629,46%,395,1145,35%,2650,5484,48%,7934,-4339,17%,04-05,04-05 Minnesota Timberwolves,13.96341463,66.87804878,80.84146341
2005,2004-05,Cleveland Cavaliers,82,19855,2990,6687,45%,300,904,33%,2690,5783,47%,7914,-4879,14%,04-05,04-05 Cleveland Cavaliers,11.02439024,70.52439024,81.54878049
2005,2004-05,San Antonio Spurs,82,19805,2923,6450,45%,507,1395,36%,2416,5055,48%,7888,-3660,22%,04-05,04-05 San Antonio Spurs,17.01219512,61.64634146,78.65853659
2005,2004-05,Los Angeles Clippers,82,20030,2924,6368,46%,231,669,35%,2693,5699,47%,7849,-5030,11%,04-05,04-05 Los Angeles Clippers,8.158536585,69.5,77.65853659
2005,2004-05,Houston Rockets,82,19855,2846,6419,44%,553,1521,36%,2293,4898,47%,7796,-3377,24%,04-05,04-05 Houston Rockets,18.54878049,59.73170732,78.2804878
2005,2004-05,Chicago Bulls,82,19830,2849,6592,43%,511,1433,36%,2338,5159,45%,7745,-3726,22%,04-05,04-05 Chicago Bulls,17.47560976,62.91463415,80.3902439
2005,2004-05,Charlotte Bobcats,82,19880,2961,6859,43%,320,881,36%,2641,5978,44%,7729,-5097,13%,04-05,04-05 Charlotte Bobcats,10.74390244,72.90243902,83.64634146
2005,2004-05,Memphis Grizzlies,82,19705,2802,6271,45%,531,1486,36%,2271,4785,48%,7661,-3299,24%,04-05,04-05 Memphis Grizzlies,18.12195122,58.35365854,76.47560976
2005,2004-05,Detroit Pistons,82,19955,2851,6421,44%,363,1053,35%,2488,5368,46%,7653,-4315,16%,04-05,04-05 Detroit Pistons,12.84146341,65.46341463,78.30487805
2005,2004-05,Indiana Pacers,82,19905,2668,6169,43%,542,1575,34%,2126,4594,46%,7626,-3019,26%,04-05,04-05 Indiana Pacers,19.20731707,56.02439024,75.23170732
2005,2004-05,Utah Jazz,82,19780,2828,6301,45%,250,762,33%,2578,5539,47%,7625,-4777,12%,04-05,04-05 Utah Jazz,9.292682927,67.54878049,76.84146341
2005,2004-05,Portland Trail Blazers,82,19730,2896,6422,45%,420,1161,36%,2476,5261,47%,7621,-4100,18%,04-05,04-05 Portland Trail Blazers,14.15853659,64.15853659,78.31707317
2005,2004-05,Atlanta Hawks,82,19855,2942,6672,44%,304,973,31%,2638,5699,46%,7605,-4726,15%,04-05,04-05 Atlanta Hawks,11.86585366,69.5,81.36585366
2005,2004-05,New Jersey Nets,82,19905,2753,6419,43%,435,1203,36%,2318,5216,44%,7496,-4013,19%,04-05,04-05 New Jersey Nets,14.67073171,63.6097561,78.2804878
2005,2004-05,New Orleans Hornets,82,19930,2718,6556,42%,415,1316,32%,2303,5240,44%,7252,-3924,20%,04-05,04-05 New Orleans Hornets,16.04878049,63.90243902,79.95121951
2003,2002-03,Dallas Mavericks,82,19780,3161,6982,45%,636,1668,38%,2525,5314,48%,8444,-3646,24%,02-03,02-03 Dallas Mavericks,20.34146341,64.80487805,85.14634146
2003,2002-03,Golden State Warriors,82,19755,3061,6941,44%,425,1235,34%,2636,5706,46%,8400,-4471,18%,02-03,02-03 Golden State Warriors,15.06097561,69.58536585,84.64634146
2003,2002-03,Sacramento Kings,82,19830,3242,6990,46%,491,1288,38%,2751,5702,48%,8342,-4414,18%,02-03,02-03 Sacramento Kings,15.70731707,69.53658537,85.24390244
2003,2002-03,Los Angeles Lakers,82,19930,3091,6856,45%,486,1367,36%,2605,5489,48%,8230,-4122,20%,02-03,02-03 Los Angeles Lakers,16.67073171,66.93902439,83.6097561
2003,2002-03,Milwaukee Bucks,82,19905,3045,6670,46%,585,1526,38%,2460,5144,48%,8158,-3618,23%,02-03,02-03 Milwaukee Bucks,18.6097561,62.73170732,81.34146341
2003,2002-03,Orlando Magic,82,19805,2947,6763,44%,568,1590,36%,2379,5173,46%,8078,-3583,24%,02-03,02-03 Orlando Magic,19.3902439,63.08536585,82.47560976
2003,2002-03,Minnesota Timberwolves,82,19805,3172,6809,47%,296,804,37%,2876,6005,48%,8046,-5201,12%,02-03,02-03 Minnesota Timberwolves,9.804878049,73.23170732,83.03658537
2003,2002-03,Memphis Grizzlies,82,19930,3049,6743,45%,467,1279,37%,2582,5464,47%,7995,-4185,19%,02-03,02-03 Memphis Grizzlies,15.59756098,66.63414634,82.23170732
2003,2002-03,Philadelphia 76ers,82,19855,2975,6640,45%,245,787,31%,2730,5853,47%,7941,-5066,12%,02-03,02-03 Philadelphia 76ers,9.597560976,71.37804878,80.97560976
2003,2002-03,Indiana Pacers,82,19905,2911,6608,44%,379,1119,34%,2532,5489,46%,7940,-4370,17%,02-03,02-03 Indiana Pacers,13.64634146,66.93902439,80.58536585
2003,2002-03,New York Knicks,82,19855,2967,6725,44%,606,1582,38%,2361,5143,46%,7860,-3561,24%,02-03,02-03 New York Knicks,19.29268293,62.7195122,82.01219512
2003,2002-03,San Antonio Spurs,82,19830,2908,6297,46%,449,1270,35%,2459,5027,49%,7856,-3757,20%,02-03,02-03 San Antonio Spurs,15.48780488,61.30487805,76.79268293
2003,2002-03,Phoenix Suns,82,19805,3005,6776,44%,394,1149,34%,2611,5627,46%,7834,-4478,17%,02-03,02-03 Phoenix Suns,14.01219512,68.62195122,82.63414634
2003,2002-03,New Jersey Nets,82,19755,2906,6585,44%,346,1041,33%,2560,5544,46%,7820,-4503,16%,02-03,02-03 New Jersey Nets,12.69512195,67.6097561,80.30487805
2003,2002-03,Portland Trail Blazers,82,19855,2987,6491,46%,379,1150,33%,2608,5341,49%,7803,-4191,18%,02-03,02-03 Portland Trail Blazers,14.02439024,65.13414634,79.15853659
2003,2002-03,Chicago Bulls,82,19930,2991,6714,45%,349,997,35%,2642,5717,46%,7786,-4720,15%,02-03,02-03 Chicago Bulls,12.15853659,69.7195122,81.87804878
2003,2002-03,Utah Jazz,82,19780,2894,6189,47%,224,641,35%,2670,5548,48%,7762,-4907,10%,02-03,02-03 Utah Jazz,7.817073171,67.65853659,75.47560976
2003,2002-03,Atlanta Hawks,82,19905,2859,6434,44%,402,1141,35%,2457,5293,46%,7714,-4152,18%,02-03,02-03 Atlanta Hawks,13.91463415,64.54878049,78.46341463
2003,2002-03,New Orleans Hornets,82,19905,2914,6695,44%,404,1075,38%,2510,5620,45%,7699,-4545,16%,02-03,02-03 New Orleans Hornets,13.1097561,68.53658537,81.64634146
2003,2002-03,Los Angeles Clippers,82,19755,2835,6490,44%,390,1178,33%,2445,5312,46%,7693,-4134,18%,02-03,02-03 Los Angeles Clippers,14.36585366,64.7804878,79.14634146
2003,2002-03,Houston Rockets,82,19930,2840,6461,44%,439,1267,35%,2401,5194,46%,7688,-3927,20%,02-03,02-03 Houston Rockets,15.45121951,63.34146341,78.79268293
2003,2002-03,Boston Celtics,82,19830,2700,6509,42%,719,2155,33%,1981,4354,46%,7599,-2199,33%,02-03,02-03 Boston Celtics,26.2804878,53.09756098,79.37804878
2003,2002-03,Seattle SuperSonics,82,19855,2887,6599,44%,456,1291,35%,2431,5308,46%,7555,-4017,20%,02-03,02-03 Seattle SuperSonics,15.74390244,64.73170732,80.47560976
2003,2002-03,Washington Wizards,82,19830,2816,6394,44%,253,811,31%,2563,5583,46%,7502,-4772,13%,02-03,02-03 Washington Wizards,9.890243902,68.08536585,77.97560976
2003,2002-03,Cleveland Cavaliers,82,19830,2850,6746,42%,293,896,33%,2557,5850,44%,7495,-4954,13%,02-03,02-03 Cleveland Cavaliers,10.92682927,71.34146341,82.26829268
2003,2002-03,Detroit Pistons,82,19905,2700,6277,43%,533,1488,36%,2167,4789,45%,7492,-3301,24%,02-03,02-03 Detroit Pistons,18.14634146,58.40243902,76.54878049
2003,2002-03,Toronto Raptors,82,19805,2847,6664,43%,409,1193,34%,2438,5471,45%,7453,-4278,18%,02-03,02-03 Toronto Raptors,14.54878049,66.7195122,81.26829268
2003,2002-03,Miami Heat,82,19830,2688,6517,41%,348,1100,32%,2340,5417,43%,7016,-4317,17%,02-03,02-03 Miami Heat,13.41463415,66.06097561,79.47560976
2003,2002-03,Denver Nuggets,82,19730,2689,6544,41%,229,824,28%,2460,5720,43%,6901,-4896,13%,02-03,02-03 Denver Nuggets,10.04878049,69.75609756,79.80487805
2002,2001-02,Dallas Mavericks,82,19880,3200,6930,46%,621,1645,38%,2579,5285,49%,8629,-3640,24%,01-02,01-02 Dallas Mavericks,20.06097561,64.45121951,84.51219512
2002,2001-02,Sacramento Kings,82,19755,3267,7003,47%,426,1160,37%,2841,5843,49%,8578,-4683,17%,01-02,01-02 Sacramento Kings,14.14634146,71.25609756,85.40243902
2002,2001-02,Los Angeles Lakers,82,19780,3150,6840,46%,510,1439,35%,2640,5401,49%,8304,-3962,21%,01-02,01-02 Los Angeles Lakers,17.54878049,65.86585366,83.41463415
2002,2001-02,Orlando Magic,82,19830,3087,6893,45%,620,1660,37%,2467,5233,47%,8240,-3573,24%,01-02,01-02 Orlando Magic,20.24390244,63.81707317,84.06097561
2002,2001-02,Minnesota Timberwolves,82,19805,3175,6887,46%,396,1047,38%,2779,5840,48%,8145,-4793,15%,01-02,01-02 Minnesota Timberwolves,12.76829268,71.2195122,83.98780488
2002,2001-02,Seattle SuperSonics,82,19830,3131,6681,47%,489,1292,38%,2642,5389,49%,8014,-4097,19%,01-02,01-02 Seattle SuperSonics,15.75609756,65.7195122,81.47560976
2002,2001-02,Golden State Warriors,82,19780,2998,6989,43%,320,994,32%,2678,5995,45%,8009,-5001,14%,01-02,01-02 Golden State Warriors,12.12195122,73.1097561,85.23170732
2002,2001-02,Milwaukee Bucks,82,19905,3041,6577,46%,593,1583,38%,2448,4994,49%,7996,-3411,24%,01-02,01-02 Milwaukee Bucks,19.30487805,60.90243902,80.20731707
2002,2001-02,Indiana Pacers,82,19905,2935,6580,45%,405,1195,34%,2530,5385,47%,7938,-4190,18%,01-02,01-02 Indiana Pacers,14.57317073,65.67073171,80.24390244
2002,2001-02,San Antonio Spurs,82,19855,2913,6363,46%,438,1211,36%,2475,5152,48%,7932,-3941,19%,01-02,01-02 San Antonio Spurs,14.76829268,62.82926829,77.59756098
2002,2001-02,Portland Trail Blazers,82,19830,3004,6671,45%,466,1318,35%,2538,5353,47%,7925,-4035,20%,01-02,01-02 Portland Trail Blazers,16.07317073,65.2804878,81.35365854
2002,2001-02,Boston Celtics,82,19830,2852,6731,42%,699,1946,36%,2153,4785,45%,7901,-2839,29%,01-02,01-02 Boston Celtics,23.73170732,58.35365854,82.08536585
2002,2001-02,New Jersey Nets,82,19830,3042,6816,45%,403,1194,34%,2639,5622,47%,7889,-4428,18%,01-02,01-02 New Jersey Nets,14.56097561,68.56097561,83.12195122
2002,2001-02,Utah Jazz,82,19830,2869,6374,45%,280,842,33%,2589,5532,47%,7871,-4690,13%,01-02,01-02 Utah Jazz,10.26829268,67.46341463,77.73170732
2002,2001-02,Los Angeles Clippers,82,19805,2970,6668,45%,408,1147,36%,2562,5521,46%,7846,-4374,17%,01-02,01-02 Los Angeles Clippers,13.98780488,67.32926829,81.31707317
2002,2001-02,Cleveland Cavaliers,82,19855,2948,6582,45%,387,1026,38%,2561,5556,46%,7812,-4530,16%,01-02,01-02 Cleveland Cavaliers,12.51219512,67.75609756,80.26829268
2002,2001-02,Phoenix Suns,82,19830,3097,6934,45%,358,1096,33%,2739,5838,47%,7802,-4742,16%,01-02,01-02 Phoenix Suns,13.36585366,71.19512195,84.56097561
2002,2001-02,Detroit Pistons,82,19680,2845,6300,45%,567,1509,38%,2278,4791,48%,7735,-3282,24%,01-02,01-02 Detroit Pistons,18.40243902,58.42682927,76.82926829
2002,2001-02,Atlanta Hawks,82,19780,2901,6610,44%,423,1194,35%,2478,5416,46%,7711,-4222,18%,01-02,01-02 Atlanta Hawks,14.56097561,66.04878049,80.6097561
2002,2001-02,Charlotte Hornets,82,19755,2893,6580,44%,346,994,35%,2547,5586,46%,7700,-4592,15%,01-02,01-02 Charlotte Hornets,12.12195122,68.12195122,80.24390244
2002,2001-02,Washington Wizards,82,19730,2938,6664,44%,305,786,39%,2633,5878,45%,7609,-5092,12%,01-02,01-02 Washington Wizards,9.585365854,71.68292683,81.26829268
2002,2001-02,Houston Rockets,82,19980,2837,6629,43%,496,1480,34%,2341,5149,46%,7572,-3669,22%,01-02,01-02 Houston Rockets,18.04878049,62.79268293,80.84146341
2002,2001-02,Denver Nuggets,82,19805,2915,6870,42%,423,1285,33%,2492,5585,45%,7559,-4300,19%,01-02,01-02 Denver Nuggets,15.67073171,68.1097561,83.7804878
2002,2001-02,New York Knicks,82,19805,2817,6520,43%,474,1344,35%,2343,5176,45%,7514,-3832,21%,01-02,01-02 New York Knicks,16.3902439,63.12195122,79.51219512
2002,2001-02,Toronto Raptors,82,19755,2919,6727,43%,387,1109,35%,2532,5618,45%,7494,-4509,16%,01-02,01-02 Toronto Raptors,13.52439024,68.51219512,82.03658537
2002,2001-02,Philadelphia 76ers,82,19730,2804,6436,44%,214,715,30%,2590,5721,45%,7461,-5006,11%,01-02,01-02 Philadelphia 76ers,8.719512195,69.76829268,78.48780488
2002,2001-02,Memphis Grizzlies,82,19780,2851,6535,44%,336,1096,31%,2515,5439,46%,7372,-4343,17%,01-02,01-02 Memphis Grizzlies,13.36585366,66.32926829,79.69512195
2002,2001-02,Chicago Bulls,82,19805,2811,6491,43%,300,868,35%,2511,5623,45%,7335,-4755,13%,01-02,01-02 Chicago Bulls,10.58536585,68.57317073,79.15853659
2002,2001-02,Miami Heat,82,19930,2801,6382,44%,312,899,35%,2489,5483,45%,7150,-4584,14%,01-02,01-02 Miami Heat,10.96341463,66.86585366,77.82926829
2001,2000-01,Sacramento Kings,82,20080,3132,6969,45%,479,1353,35%,2653,5616,47%,8343,-4263,19%,00-01,00-01 Sacramento Kings,16.5,68.48780488,84.98780488
2001,2000-01,Milwaukee Bucks,82,19780,3112,6798,46%,562,1481,38%,2550,5317,48%,8260,-3836,22%,00-01,00-01 Milwaukee Bucks,18.06097561,64.84146341,82.90243902
2001,2000-01,Los Angeles Lakers,82,19905,3109,6685,47%,439,1275,34%,2670,5410,49%,8251,-4135,19%,00-01,00-01 Los Angeles Lakers,15.54878049,65.97560976,81.52439024
2001,2000-01,Dallas Mavericks,82,19805,3085,6716,46%,517,1357,38%,2568,5359,48%,8239,-4002,20%,00-01,00-01 Dallas Mavericks,16.54878049,65.35365854,81.90243902
2001,2000-01,Toronto Raptors,82,19955,3048,6972,44%,429,1164,37%,2619,5808,45%,8007,-4644,17%,00-01,00-01 Toronto Raptors,14.19512195,70.82926829,85.02439024
2001,2000-01,Orlando Magic,82,19955,3013,6873,44%,490,1346,36%,2523,5527,46%,7992,-4181,20%,00-01,00-01 Orlando Magic,16.41463415,67.40243902,83.81707317
2001,2000-01,Minnesota Timberwolves,82,19830,3148,6871,46%,322,901,36%,2826,5970,47%,7982,-5069,13%,00-01,00-01 Minnesota Timberwolves,10.98780488,72.80487805,83.79268293
2001,2000-01,Seattle SuperSonics,82,19805,3029,6649,46%,466,1169,40%,2563,5480,47%,7978,-4311,18%,00-01,00-01 Seattle SuperSonics,14.25609756,66.82926829,81.08536585
2001,2000-01,Houston Rockets,82,19830,2943,6494,45%,504,1412,36%,2439,5082,48%,7972,-3670,22%,00-01,00-01 Houston Rockets,17.2195122,61.97560976,79.19512195
2001,2000-01,Utah Jazz,82,19780,2960,6289,47%,325,852,38%,2635,5437,49%,7959,-4585,14%,00-01,00-01 Utah Jazz,10.3902439,66.30487805,76.69512195
2001,2000-01,Denver Nuggets,82,19780,2979,6877,43%,512,1444,36%,2467,5433,45%,7918,-3989,21%,00-01,00-01 Denver Nuggets,17.6097561,66.25609756,83.86585366
2001,2000-01,San Antonio Spurs,82,19830,2884,6262,46%,445,1094,41%,2439,5168,47%,7886,-4074,17%,00-01,00-01 San Antonio Spurs,13.34146341,63.02439024,76.36585366
2001,2000-01,Detroit Pistons,82,19855,2919,6880,42%,389,1112,35%,2530,5768,44%,7837,-4656,16%,00-01,00-01 Detroit Pistons,13.56097561,70.34146341,83.90243902
2001,2000-01,Portland Trail Blazers,82,19780,3004,6417,47%,369,1057,35%,2635,5360,49%,7824,-4303,16%,00-01,00-01 Portland Trail Blazers,12.8902439,65.36585366,78.25609756
2001,2000-01,Philadelphia 76ers,82,19855,2902,6487,45%,262,803,33%,2640,5684,46%,7763,-4881,12%,00-01,00-01 Philadelphia 76ers,9.792682927,69.31707317,79.1097561
2001,2000-01,Boston Celtics,82,19830,2773,6485,43%,592,1633,36%,2181,4852,45%,7759,-3219,25%,00-01,00-01 Boston Celtics,19.91463415,59.17073171,79.08536585
2001,2000-01,Phoenix Suns,82,19805,2944,6757,44%,332,1054,32%,2612,5703,46%,7710,-4649,16%,00-01,00-01 Phoenix Suns,12.85365854,69.54878049,82.40243902
2001,2000-01,Washington Wizards,82,19680,2833,6453,44%,275,848,32%,2558,5605,46%,7645,-4757,13%,00-01,00-01 Washington Wizards,10.34146341,68.35365854,78.69512195
2001,2000-01,Indiana Pacers,82,19980,2828,6431,44%,396,1159,34%,2432,5272,46%,7591,-4113,18%,00-01,00-01 Indiana Pacers,14.13414634,64.29268293,78.42682927
2001,2000-01,Golden State Warriors,82,19780,2937,7175,41%,282,964,29%,2655,6211,43%,7584,-5247,13%,00-01,00-01 Golden State Warriors,11.75609756,75.74390244,87.5
2001,2000-01,Los Angeles Clippers,82,20030,2896,6467,45%,360,1063,34%,2536,5404,47%,7581,-4341,16%,00-01,00-01 Los Angeles Clippers,12.96341463,65.90243902,78.86585366
2001,2000-01,Cleveland Cavaliers,82,19830,2890,6532,44%,220,659,33%,2670,5873,46%,7561,-5214,10%,00-01,00-01 Cleveland Cavaliers,8.036585366,71.62195122,79.65853659
2001,2000-01,New Jersey Nets,82,19730,2781,6550,43%,361,1084,33%,2420,5466,44%,7552,-4382,17%,00-01,00-01 New Jersey Nets,13.2195122,66.65853659,79.87804878
2001,2000-01,Charlotte Hornets,82,19880,2800,6501,43%,340,984,35%,2460,5517,45%,7539,-4533,15%,00-01,00-01 Charlotte Hornets,12,67.2804878,79.2804878
2001,2000-01,Vancouver Grizzlies,82,19780,2870,6539,44%,325,947,34%,2545,5592,46%,7522,-4645,14%,00-01,00-01 Vancouver Grizzlies,11.54878049,68.19512195,79.74390244
2001,2000-01,Atlanta Hawks,82,19730,2876,6668,43%,333,933,36%,2543,5735,44%,7459,-4802,14%,00-01,00-01 Atlanta Hawks,11.37804878,69.93902439,81.31707317
2001,2000-01,Miami Heat,82,19880,2694,6258,43%,478,1384,35%,2216,4874,46%,7289,-3490,22%,00-01,00-01 Miami Heat,16.87804878,59.43902439,76.31707317
2001,2000-01,New York Knicks,82,19905,2755,6198,44%,391,1115,35%,2364,5083,47%,7275,-3968,18%,00-01,00-01 New York Knicks,13.59756098,61.98780488,75.58536585
2001,2000-01,Chicago Bulls,82,19855,2721,6411,42%,329,950,35%,2392,5461,44%,7181,-4511,15%,00-01,00-01 Chicago Bulls,11.58536585,66.59756098,78.18292683
2000,1999-00,Sacramento Kings,82,19805,3276,7288,45%,534,1656,32%,2742,5632,49%,8607,-3976,23%,99-00,99-00 Sacramento Kings,20.19512195,68.68292683,88.87804878
2000,1999-00,Detroit Pistons,82,19830,3044,6635,46%,439,1223,36%,2605,5412,48%,8483,-4189,18%,99-00,99-00 Detroit Pistons,14.91463415,66,80.91463415
2000,1999-00,Dallas Mavericks,82,19730,3195,7047,45%,519,1326,39%,2676,5721,47%,8316,-4395,19%,99-00,99-00 Dallas Mavericks,16.17073171,69.76829268,85.93902439
2000,1999-00,Indiana Pacers,82,19730,3047,6640,46%,583,1487,39%,2464,5153,48%,8306,-3666,22%,99-00,99-00 Indiana Pacers,18.13414634,62.84146341,80.97560976
2000,1999-00,Milwaukee Bucks,82,19855,3174,6827,47%,394,1069,37%,2780,5758,48%,8300,-4689,16%,99-00,99-00 Milwaukee Bucks,13.03658537,70.2195122,83.25609756
2000,1999-00,Los Angeles Lakers,82,19805,3137,6836,46%,344,1047,33%,2793,5789,48%,8267,-4742,15%,99-00,99-00 Los Angeles Lakers,12.76829268,70.59756098,83.36585366
2000,1999-00,Orlando Magic,82,19755,3169,7014,45%,294,870,34%,2875,6144,47%,8206,-5274,12%,99-00,99-00 Orlando Magic,10.6097561,74.92682927,85.53658537
2000,1999-00,Houston Rockets,82,19830,3001,6664,45%,581,1625,36%,2420,5039,48%,8156,-3414,24%,99-00,99-00 Houston Rockets,19.81707317,61.45121951,81.26829268
2000,1999-00,Boston Celtics,82,19730,3054,6880,44%,417,1260,33%,2637,5620,47%,8146,-4360,18%,99-00,99-00 Boston Celtics,15.36585366,68.53658537,83.90243902
2000,1999-00,Seattle SuperSonics,82,19780,3108,6946,45%,546,1611,34%,2562,5335,48%,8125,-3724,23%,99-00,99-00 Seattle SuperSonics,19.64634146,65.06097561,84.70731707
2000,1999-00,Denver Nuggets,82,19855,3057,6911,44%,470,1397,34%,2587,5514,47%,8115,-4117,20%,99-00,99-00 Denver Nuggets,17.03658537,67.24390244,84.2804878
2000,1999-00,Phoenix Suns,82,19805,3093,6771,46%,458,1246,37%,2635,5525,48%,8111,-4279,18%,99-00,99-00 Phoenix Suns,15.19512195,67.37804878,82.57317073
2000,1999-00,Minnesota Timberwolves,82,19905,3226,6910,47%,248,716,35%,2978,6194,48%,8079,-5478,10%,99-00,99-00 Minnesota Timberwolves,8.731707317,75.53658537,84.26829268
2000,1999-00,Charlotte Hornets,82,19780,2935,6533,45%,339,1001,34%,2596,5532,47%,8072,-4531,15%,99-00,99-00 Charlotte Hornets,12.20731707,67.46341463,79.67073171
2000,1999-00,New Jersey Nets,82,19830,2979,6881,43%,477,1374,35%,2502,5507,45%,8036,-4133,20%,99-00,99-00 New Jersey Nets,16.75609756,67.15853659,83.91463415
2000,1999-00,Portland Trail Blazers,82,19780,3021,6430,47%,407,1128,36%,2614,5302,49%,7991,-4174,18%,99-00,99-00 Portland Trail Blazers,13.75609756,64.65853659,78.41463415
2000,1999-00,Toronto Raptors,82,19755,2980,6882,43%,425,1171,36%,2555,5711,45%,7968,-4540,17%,99-00,99-00 Toronto Raptors,14.2804878,69.64634146,83.92682927
2000,1999-00,Cleveland Cavaliers,82,19855,2977,6734,44%,343,919,37%,2634,5815,45%,7950,-4896,14%,99-00,99-00 Cleveland Cavaliers,11.20731707,70.91463415,82.12195122
2000,1999-00,Washington Wizards,82,19805,3010,6681,45%,335,890,38%,2675,5791,46%,7921,-4901,13%,99-00,99-00 Washington Wizards,10.85365854,70.62195122,81.47560976
2000,1999-00,Utah Jazz,82,19755,2962,6380,46%,329,854,39%,2633,5526,48%,7914,-4672,13%,99-00,99-00 Utah Jazz,10.41463415,67.3902439,77.80487805
2000,1999-00,San Antonio Spurs,82,19855,2952,6393,46%,330,882,37%,2622,5511,48%,7886,-4629,14%,99-00,99-00 San Antonio Spurs,10.75609756,67.20731707,77.96341463
2000,1999-00,Golden State Warriors,82,19755,2996,7140,42%,345,1069,32%,2651,6071,44%,7834,-5002,15%,99-00,99-00 Golden State Warriors,13.03658537,74.03658537,87.07317073
2000,1999-00,Philadelphia 76ers,82,19830,2993,6776,44%,208,643,32%,2785,6133,45%,7771,-5490,9%,99-00,99-00 Philadelphia 76ers,7.841463415,74.79268293,82.63414634
2000,1999-00,Miami Heat,82,19830,2974,6462,46%,446,1202,37%,2528,5260,48%,7739,-4058,19%,99-00,99-00 Miami Heat,14.65853659,64.14634146,78.80487805
2000,1999-00,Atlanta Hawks,82,19830,3000,6807,44%,258,814,32%,2742,5993,46%,7735,-5179,12%,99-00,99-00 Atlanta Hawks,9.926829268,73.08536585,83.01219512
2000,1999-00,Vancouver Grizzlies,82,19855,2892,6441,45%,324,898,36%,2568,5543,46%,7702,-4645,14%,99-00,99-00 Vancouver Grizzlies,10.95121951,67.59756098,78.54878049
2000,1999-00,New York Knicks,82,19830,2897,6374,46%,351,937,38%,2546,5437,47%,7555,-4500,15%,99-00,99-00 New York Knicks,11.42682927,66.30487805,77.73170732
2000,1999-00,Los Angeles Clippers,82,19705,2877,6757,43%,429,1267,34%,2448,5490,45%,7546,-4223,19%,99-00,99-00 Los Angeles Clippers,15.45121951,66.95121951,82.40243902
2000,1999-00,Chicago Bulls,82,19805,2565,6180,42%,340,1032,33%,2225,5148,43%,6952,-4116,17%,99-00,99-00 Chicago Bulls,12.58536585,62.7804878,75.36585366
1999,1998-99,Sacramento Kings,50,12200,1918,4307,45%,290,943,31%,1628,3364,48%,5009,-2421,22%,98-99,98-99 Sacramento Kings,18.86,67.28,86.14
1999,1998-99,Los Angeles Lakers,50,12050,1841,3935,47%,241,685,35%,1600,3250,49%,4950,-2565,17%,98-99,98-99 Los Angeles Lakers,13.7,65,78.7
1999,1998-99,Phoenix Suns,50,12050,1797,4004,45%,261,702,37%,1536,3302,47%,4779,-2600,18%,98-99,98-99 Phoenix Suns,14.04,66.04,80.08
1999,1998-99,Seattle SuperSonics,50,12100,1756,3976,44%,309,899,34%,1447,3077,47%,4743,-2178,23%,98-99,98-99 Seattle SuperSonics,17.98,61.54,79.52
1999,1998-99,Portland Trail Blazers,50,12175,1747,3956,44%,246,675,36%,1501,3281,46%,4742,-2606,17%,98-99,98-99 Portland Trail Blazers,13.5,65.62,79.12
1999,1998-99,Indiana Pacers,50,12100,1731,3866,45%,294,799,37%,1437,3067,47%,4733,-2268,21%,98-99,98-99 Indiana Pacers,15.98,61.34,77.32
1999,1998-99,Houston Rockets,50,12075,1755,3798,46%,336,914,37%,1419,2884,49%,4711,-1970,24%,98-99,98-99 Houston Rockets,18.28,57.68,75.96
1999,1998-99,Denver Nuggets,50,12025,1681,3989,42%,302,922,33%,1379,3067,45%,4674,-2145,23%,98-99,98-99 Denver Nuggets,18.44,61.34,79.78
1999,1998-99,Utah Jazz,50,12175,1684,3620,47%,140,388,36%,1544,3232,48%,4666,-2844,11%,98-99,98-99 Utah Jazz,7.76,64.64,72.4
1999,1998-99,Boston Celtics,50,12150,1816,4164,44%,273,758,36%,1543,3406,45%,4650,-2648,18%,98-99,98-99 Boston Celtics,15.16,68.12,83.28
1999,1998-99,Minnesota Timberwolves,50,12025,1838,4327,43%,122,410,30%,1716,3917,44%,4647,-3507,9%,98-99,98-99 Minnesota Timberwolves,8.2,78.34,86.54
1999,1998-99,Charlotte Hornets,50,12150,1671,3718,45%,268,735,37%,1403,2983,47%,4644,-2248,20%,98-99,98-99 Charlotte Hornets,14.7,59.66,74.36
1999,1998-99,San Antonio Spurs,50,12075,1740,3812,46%,172,521,33%,1568,3291,48%,4640,-2770,14%,98-99,98-99 San Antonio Spurs,10.42,65.82,76.24
1999,1998-99,Milwaukee Bucks,50,12050,1753,3818,46%,231,619,37%,1522,3199,48%,4584,-2580,16%,98-99,98-99 Milwaukee Bucks,12.38,63.98,76.36
1999,1998-99,Dallas Mavericks,50,12075,1749,4033,43%,202,595,34%,1547,3438,45%,4581,-2843,15%,98-99,98-99 Dallas Mavericks,11.9,68.76,80.66
1999,1998-99,New Jersey Nets,50,12050,1691,4160,41%,225,679,33%,1466,3481,42%,4569,-2802,16%,98-99,98-99 New Jersey Nets,13.58,69.62,83.2
1999,1998-99,Washington Wizards,50,12050,1768,3969,45%,179,580,31%,1589,3389,47%,4560,-2809,15%,98-99,98-99 Washington Wizards,11.6,67.78,79.38
1999,1998-99,Toronto Raptors,50,12075,1660,3940,42%,226,662,34%,1434,3278,44%,4557,-2616,17%,98-99,98-99 Toronto Raptors,13.24,65.56,78.8
1999,1998-99,Los Angeles Clippers,50,12125,1711,4007,43%,214,668,32%,1497,3339,45%,4519,-2671,17%,98-99,98-99 Los Angeles Clippers,13.36,66.78,80.14
1999,1998-99,Detroit Pistons,50,12050,1660,3716,45%,248,679,37%,1412,3037,47%,4518,-2358,18%,98-99,98-99 Detroit Pistons,13.58,60.74,74.32
1999,1998-99,Philadelphia 76ers,50,12150,1656,3883,43%,98,371,26%,1558,3512,44%,4483,-3141,10%,98-99,98-99 Philadelphia 76ers,7.42,70.24,77.66
1999,1998-99,Orlando Magic,50,12050,1687,3943,43%,223,675,33%,1464,3268,45%,4473,-2593,17%,98-99,98-99 Orlando Magic,13.5,65.36,78.86
1999,1998-99,Miami Heat,50,12025,1616,3565,45%,289,804,36%,1327,2761,48%,4449,-1957,23%,98-99,98-99 Miami Heat,16.08,55.22,71.3
1999,1998-99,Vancouver Grizzlies,50,12175,1643,3838,43%,148,453,33%,1495,3385,44%,4443,-2932,12%,98-99,98-99 Vancouver Grizzlies,9.06,67.7,76.76
1999,1998-99,Golden State Warriors,50,12125,1730,4173,42%,162,565,29%,1568,3608,44%,4416,-3043,14%,98-99,98-99 Golden State Warriors,11.3,72.16,83.46
1999,1998-99,Cleveland Cavaliers,50,12050,1562,3561,44%,182,534,34%,1380,3027,46%,4322,-2493,15%,98-99,98-99 Cleveland Cavaliers,10.68,60.54,71.22
1999,1998-99,New York Knicks,50,12100,1610,3704,44%,208,589,35%,1402,3115,45%,4320,-2526,16%,98-99,98-99 New York Knicks,11.78,62.3,74.08
1999,1998-99,Atlanta Hawks,50,12075,1539,3760,41%,197,644,31%,1342,3116,43%,4315,-2472,17%,98-99,98-99 Atlanta Hawks,12.88,62.32,75.2
1999,1998-99,Chicago Bulls,50,12075,1539,3837,40%,177,612,29%,1362,3225,42%,4095,-2613,16%,98-99,98-99 Chicago Bulls,12.24,64.5,76.74
1998,1997-98,Los Angeles Lakers,82,19830,3146,6536,48%,497,1415,35%,2649,5121,52%,8652,-3706,22%,97-98,97-98 Los Angeles Lakers,17.25609756,62.45121951,79.70731707
1998,1997-98,Minnesota Timberwolves,82,19930,3157,6844,46%,303,873,35%,2854,5971,48%,8290,-5098,13%,97-98,97-98 Minnesota Timberwolves,10.64634146,72.81707317,83.46341463
1998,1997-98,Utah Jazz,82,19780,2993,6113,49%,249,670,37%,2744,5443,50%,8279,-4773,11%,97-98,97-98 Utah Jazz,8.170731707,66.37804878,74.54878049
1998,1997-98,Seattle SuperSonics,82,19755,3052,6458,47%,621,1569,40%,2431,4889,50%,8246,-3320,24%,97-98,97-98 Seattle SuperSonics,19.13414634,59.62195122,78.75609756
1998,1997-98,New Jersey Nets,82,19880,3055,6928,44%,310,937,33%,2745,5991,46%,8170,-5054,14%,97-98,97-98 New Jersey Nets,11.42682927,73.06097561,84.48780488
1998,1997-98,Phoenix Suns,82,19955,3138,6710,47%,431,1211,36%,2707,5499,49%,8166,-4288,18%,97-98,97-98 Phoenix Suns,14.76829268,67.06097561,81.82926829
1998,1997-98,Houston Rockets,82,19830,2946,6513,45%,573,1670,34%,2373,4843,49%,8099,-3173,26%,97-98,97-98 Houston Rockets,20.36585366,59.06097561,79.42682927
1998,1997-98,Washington Wizards,82,19805,3080,6811,45%,320,944,34%,2760,5867,47%,7969,-4923,14%,97-98,97-98 Washington Wizards,11.51219512,71.54878049,83.06097561
1998,1997-98,Chicago Bulls,82,19855,3064,6801,45%,311,962,32%,2753,5839,47%,7931,-4877,14%,97-98,97-98 Chicago Bulls,11.73170732,71.20731707,82.93902439
1998,1997-98,Charlotte Hornets,82,19780,2968,6344,47%,346,904,38%,2622,5440,48%,7923,-4536,14%,97-98,97-98 Charlotte Hornets,11.02439024,66.34146341,77.36585366
1998,1997-98,Vancouver Grizzlies,82,19830,3006,6567,46%,325,898,36%,2681,5669,47%,7923,-4771,14%,97-98,97-98 Vancouver Grizzlies,10.95121951,69.13414634,80.08536585
1998,1997-98,Indiana Pacers,82,19830,2921,6223,47%,401,1029,39%,2520,5194,49%,7874,-4165,17%,97-98,97-98 Indiana Pacers,12.54878049,63.34146341,75.8902439
1998,1997-98,Los Angeles Clippers,82,19780,2930,6690,44%,525,1468,36%,2405,5222,46%,7865,-3754,22%,97-98,97-98 Los Angeles Clippers,17.90243902,63.68292683,81.58536585
1998,1997-98,Boston Celtics,82,19730,3012,6934,43%,415,1249,33%,2597,5685,46%,7864,-4436,18%,97-98,97-98 Boston Celtics,15.23170732,69.32926829,84.56097561
1998,1997-98,Atlanta Hawks,82,19880,2887,6352,46%,337,1016,33%,2550,5336,48%,7860,-4320,16%,97-98,97-98 Atlanta Hawks,12.3902439,65.07317073,77.46341463
1998,1997-98,Miami Heat,82,19755,2850,6327,45%,548,1544,36%,2302,4783,48%,7787,-3239,24%,97-98,97-98 Miami Heat,18.82926829,58.32926829,77.15853659
1998,1997-98,Toronto Raptors,82,19930,2965,6813,44%,372,1086,34%,2593,5727,45%,7781,-4641,16%,97-98,97-98 Toronto Raptors,13.24390244,69.84146341,83.08536585
1998,1997-98,Milwaukee Bucks,82,19930,2918,6399,46%,249,703,35%,2669,5696,47%,7748,-4993,11%,97-98,97-98 Milwaukee Bucks,8.573170732,69.46341463,78.03658537
1998,1997-98,Portland Trail Blazers,82,19830,2885,6397,45%,324,1047,31%,2561,5350,48%,7734,-4303,16%,97-98,97-98 Portland Trail Blazers,12.76829268,65.24390244,78.01219512
1998,1997-98,Detroit Pistons,82,19955,2862,6373,45%,293,938,31%,2569,5435,47%,7721,-4497,15%,97-98,97-98 Detroit Pistons,11.43902439,66.2804878,77.7195122
1998,1997-98,Philadelphia 76ers,82,19755,2837,6409,44%,243,810,30%,2594,5599,46%,7651,-4789,13%,97-98,97-98 Philadelphia 76ers,9.87804878,68.2804878,78.15853659
1998,1997-98,Sacramento Kings,82,19730,2957,6684,44%,283,806,35%,2674,5878,46%,7637,-5072,12%,97-98,97-98 Sacramento Kings,9.829268293,71.68292683,81.51219512
1998,1997-98,San Antonio Spurs,82,19830,2898,6187,47%,302,863,35%,2596,5324,49%,7587,-4461,14%,97-98,97-98 San Antonio Spurs,10.52439024,64.92682927,75.45121951
1998,1997-98,Cleveland Cavaliers,82,19830,2817,6207,45%,298,801,37%,2519,5406,47%,7585,-4605,13%,97-98,97-98 Cleveland Cavaliers,9.768292683,65.92682927,75.69512195
1998,1997-98,New York Knicks,82,19830,2864,6413,45%,382,1139,34%,2482,5274,47%,7509,-4135,18%,97-98,97-98 New York Knicks,13.8902439,64.31707317,78.20731707
1998,1997-98,Dallas Mavericks,82,19905,2882,6754,43%,422,1183,36%,2460,5571,44%,7494,-4388,18%,97-98,97-98 Dallas Mavericks,14.42682927,67.93902439,82.36585366
1998,1997-98,Orlando Magic,82,19830,2771,6455,43%,293,907,32%,2478,5548,45%,7387,-4641,14%,97-98,97-98 Orlando Magic,11.06097561,67.65853659,78.7195122
1998,1997-98,Denver Nuggets,82,19730,2677,6412,42%,288,893,32%,2389,5519,43%,7300,-4626,14%,97-98,97-98 Denver Nuggets,10.8902439,67.30487805,78.19512195
1998,1997-98,Golden State Warriors,82,19830,2845,6883,41%,189,696,27%,2656,6187,43%,7237,-5491,10%,97-98,97-98 Golden State Warriors,8.487804878,75.45121951,83.93902439
1997,1996-97,Chicago Bulls,82,19730,3277,6923,47%,523,1403,37%,2754,5520,50%,8458,-4117,20%,96-97,96-97 Chicago Bulls,17.1097561,67.31707317,84.42682927
1997,1996-97,Utah Jazz,82,19830,3131,6217,50%,334,902,37%,2797,5315,53%,8454,-4413,15%,96-97,96-97 Utah Jazz,11,64.81707317,75.81707317
1997,1996-97,Phoenix Suns,82,19855,3143,6705,47%,527,1428,37%,2616,5277,50%,8431,-3849,21%,96-97,96-97 Phoenix Suns,17.41463415,64.35365854,81.76829268
1997,1996-97,Seattle SuperSonics,82,19780,2995,6415,47%,559,1583,35%,2436,4832,50%,8274,-3249,25%,96-97,96-97 Seattle SuperSonics,19.30487805,58.92682927,78.23170732
1997,1996-97,Boston Celtics,82,19905,3066,6967,44%,467,1331,35%,2599,5636,46%,8248,-4305,19%,96-97,96-97 Boston Celtics,16.23170732,68.73170732,84.96341463
1997,1996-97,Houston Rockets,82,19855,3037,6484,47%,671,1839,37%,2366,4645,51%,8248,-2806,28%,96-97,96-97 Houston Rockets,22.42682927,56.64634146,79.07317073
1997,1996-97,Philadelphia 76ers,82,19780,3003,6850,44%,433,1356,32%,2570,5494,47%,8215,-4138,20%,96-97,96-97 Philadelphia 76ers,16.53658537,67,83.53658537
1997,1996-97,Los Angeles Lakers,82,19930,3018,6642,45%,551,1500,37%,2467,5142,48%,8200,-3642,23%,96-97,96-97 Los Angeles Lakers,18.29268293,62.70731707,81
1997,1996-97,Golden State Warriors,82,19905,2997,6567,46%,481,1363,35%,2516,5204,48%,8171,-3841,21%,96-97,96-97 Golden State Warriors,16.62195122,63.46341463,80.08536585
1997,1996-97,Washington Bullets,82,19855,3208,6678,48%,331,1001,33%,2877,5677,51%,8147,-4676,15%,96-97,96-97 Washington Bullets,12.20731707,69.23170732,81.43902439
1997,1996-97,Portland Trail Blazers,82,19855,3000,6465,46%,501,1401,36%,2499,5064,49%,8114,-3663,22%,96-97,96-97 Portland Trail Blazers,17.08536585,61.75609756,78.84146341
1997,1996-97,Charlotte Hornets,82,19805,2988,6342,47%,591,1382,43%,2397,4960,48%,8108,-3578,22%,96-97,96-97 Charlotte Hornets,16.85365854,60.48780488,77.34146341
1997,1996-97,Denver Nuggets,82,19930,2934,6687,44%,636,1711,37%,2298,4976,46%,8020,-3265,26%,96-97,96-97 Denver Nuggets,20.86585366,60.68292683,81.54878049
1997,1996-97,New Jersey Nets,82,19780,2994,7091,42%,484,1371,35%,2510,5720,44%,7974,-4349,19%,96-97,96-97 New Jersey Nets,16.7195122,69.75609756,86.47560976
1997,1996-97,Los Angeles Clippers,82,19930,2989,6696,45%,474,1339,35%,2515,5357,47%,7969,-4018,20%,96-97,96-97 Los Angeles Clippers,16.32926829,65.32926829,81.65853659
1997,1996-97,Sacramento Kings,82,19855,3000,6611,45%,414,1058,39%,2586,5553,47%,7908,-4495,16%,96-97,96-97 Sacramento Kings,12.90243902,67.7195122,80.62195122
1997,1996-97,Minnesota Timberwolves,82,19780,2937,6436,46%,371,1093,34%,2566,5343,48%,7882,-4250,17%,96-97,96-97 Minnesota Timberwolves,13.32926829,65.15853659,78.48780488
1997,1996-97,Toronto Raptors,82,19830,2897,6632,44%,589,1624,36%,2308,5008,46%,7829,-3384,24%,96-97,96-97 Toronto Raptors,19.80487805,61.07317073,80.87804878
1997,1996-97,New York Knicks,82,19855,2882,6227,46%,470,1294,36%,2412,4933,49%,7819,-3639,21%,96-97,96-97 New York Knicks,15.7804878,60.15853659,75.93902439
1997,1996-97,Indiana Pacers,82,19930,2851,6254,46%,430,1130,38%,2421,5124,47%,7819,-3994,18%,96-97,96-97 Indiana Pacers,13.7804878,62.48780488,76.26829268
1997,1996-97,Milwaukee Bucks,82,19730,2967,6303,47%,324,920,35%,2643,5383,49%,7818,-4463,15%,96-97,96-97 Milwaukee Bucks,11.2195122,65.64634146,76.86585366
1997,1996-97,Miami Heat,82,19805,2822,6235,45%,678,1865,36%,2144,4370,49%,7776,-2505,30%,96-97,96-97 Miami Heat,22.74390244,53.29268293,76.03658537
1997,1996-97,Atlanta Hawks,82,19805,2812,6307,45%,659,1834,36%,2153,4473,48%,7774,-2639,29%,96-97,96-97 Atlanta Hawks,22.36585366,54.54878049,76.91463415
1997,1996-97,Detroit Pistons,82,19830,2827,6095,46%,582,1499,39%,2245,4596,49%,7723,-3097,25%,96-97,96-97 Detroit Pistons,18.2804878,56.04878049,74.32926829
1997,1996-97,Orlando Magic,82,19855,2839,6497,44%,567,1662,34%,2272,4835,47%,7719,-3173,26%,96-97,96-97 Orlando Magic,20.26829268,58.96341463,79.23170732
1997,1996-97,Dallas Mavericks,82,19805,2813,6452,44%,430,1316,33%,2383,5136,46%,7431,-3820,20%,96-97,96-97 Dallas Mavericks,16.04878049,62.63414634,78.68292683
1997,1996-97,San Antonio Spurs,82,19730,2827,6391,44%,378,1180,32%,2449,5211,47%,7418,-4031,18%,96-97,96-97 San Antonio Spurs,14.3902439,63.54878049,77.93902439
1997,1996-97,Vancouver Grizzlies,82,19780,2819,6453,44%,445,1274,35%,2374,5179,46%,7313,-3905,20%,96-97,96-97 Vancouver Grizzlies,15.53658537,63.15853659,78.69512195
1997,1996-97,Cleveland Cavaliers,82,19855,2704,5972,45%,483,1284,38%,2221,4688,47%,7173,-3404,22%,96-97,96-97 Cleveland Cavaliers,15.65853659,57.17073171,72.82926829
1996,1995-96,Chicago Bulls,82,19730,3293,6892,48%,544,1349,40%,2749,5543,50%,8625,-4194,20%,95-96,95-96 Chicago Bulls,16.45121951,67.59756098,84.04878049
1996,1995-96,Seattle SuperSonics,82,19880,3074,6401,48%,581,1596,36%,2493,4805,52%,8572,-3209,25%,95-96,95-96 Seattle SuperSonics,19.46341463,58.59756098,78.06097561
1996,1995-96,Orlando Magic,82,19855,3203,6640,48%,622,1645,38%,2581,4995,52%,8571,-3350,25%,95-96,95-96 Orlando Magic,20.06097561,60.91463415,80.97560976
1996,1995-96,Phoenix Suns,82,19955,3159,6673,47%,327,984,33%,2832,5689,50%,8552,-4705,15%,95-96,95-96 Phoenix Suns,12,69.37804878,81.37804878
1996,1995-96,Boston Celtics,82,19905,3163,6942,46%,539,1453,37%,2624,5489,48%,8495,-4036,21%,95-96,95-96 Boston Celtics,17.7195122,66.93902439,84.65853659
1996,1995-96,San Antonio Spurs,82,19780,3148,6602,48%,518,1320,39%,2630,5282,50%,8477,-3962,20%,95-96,95-96 San Antonio Spurs,16.09756098,64.41463415,80.51219512
1996,1995-96,Los Angeles Lakers,82,19680,3216,6706,48%,477,1359,35%,2739,5347,51%,8438,-3988,20%,95-96,95-96 Los Angeles Lakers,16.57317073,65.20731707,81.7804878
1996,1995-96,Charlotte Hornets,82,19880,3108,6618,47%,584,1520,38%,2524,5098,50%,8431,-3578,23%,95-96,95-96 Charlotte Hornets,18.53658537,62.17073171,80.70731707
1996,1995-96,Dallas Mavericks,82,19930,3124,7431,42%,735,2039,36%,2389,5392,44%,8409,-3353,27%,95-96,95-96 Dallas Mavericks,24.86585366,65.75609756,90.62195122
1996,1995-96,Washington Bullets,82,19805,3202,6618,48%,493,1212,41%,2709,5406,50%,8408,-4194,18%,95-96,95-96 Washington Bullets,14.7804878,65.92682927,80.70731707
1996,1995-96,Houston Rockets,82,19805,3078,6638,46%,637,1761,36%,2441,4877,50%,8404,-3116,27%,95-96,95-96 Houston Rockets,21.47560976,59.47560976,80.95121951
1996,1995-96,Utah Jazz,82,19780,3129,6417,49%,377,1013,37%,2752,5404,51%,8404,-4391,16%,95-96,95-96 Utah Jazz,12.35365854,65.90243902,78.25609756
1996,1995-96,Golden State Warriors,82,19755,3056,6700,46%,447,1199,37%,2609,5501,47%,8334,-4302,18%,95-96,95-96 Golden State Warriors,14.62195122,67.08536585,81.70731707
1996,1995-96,Sacramento Kings,82,19755,2971,6494,46%,462,1194,39%,2509,5300,47%,8163,-4106,18%,95-96,95-96 Sacramento Kings,14.56097561,64.63414634,79.19512195
1996,1995-96,Los Angeles Clippers,82,19730,3126,6618,47%,509,1374,37%,2617,5244,50%,8153,-3870,21%,95-96,95-96 Los Angeles Clippers,16.75609756,63.95121951,80.70731707
1996,1995-96,Portland Trail Blazers,82,19905,3064,6688,46%,480,1358,35%,2584,5330,49%,8145,-3972,20%,95-96,95-96 Portland Trail Blazers,16.56097561,65,81.56097561
1996,1995-96,Indiana Pacers,82,19755,2979,6205,48%,363,973,37%,2616,5232,50%,8144,-4259,16%,95-96,95-96 Indiana Pacers,11.86585366,63.80487805,75.67073171
1996,1995-96,Atlanta Hawks,82,19730,2985,6665,45%,566,1595,36%,2419,5070,48%,8059,-3475,24%,95-96,95-96 Atlanta Hawks,19.45121951,61.82926829,81.2804878
1996,1995-96,Minnesota Timberwolves,82,19780,2974,6481,46%,279,857,33%,2695,5624,48%,8024,-4767,13%,95-96,95-96 Minnesota Timberwolves,10.45121951,68.58536585,79.03658537
1996,1995-96,Denver Nuggets,82,19830,3001,6657,45%,397,1148,35%,2604,5509,47%,8013,-4361,17%,95-96,95-96 Denver Nuggets,14,67.18292683,81.18292683
1996,1995-96,Toronto Raptors,82,19830,3084,6598,47%,414,1168,35%,2670,5430,49%,7994,-4262,18%,95-96,95-96 Toronto Raptors,14.24390244,66.2195122,80.46341463
1996,1995-96,New York Knicks,82,19830,3003,6382,47%,485,1285,38%,2518,5097,49%,7971,-3812,20%,95-96,95-96 New York Knicks,15.67073171,62.15853659,77.82926829
1996,1995-96,Miami Heat,82,19780,2902,6348,46%,552,1458,38%,2350,4890,48%,7909,-3432,23%,95-96,95-96 Miami Heat,17.7804878,59.63414634,77.41463415
1996,1995-96,Milwaukee Bucks,82,19730,3034,6490,47%,357,1056,34%,2677,5434,49%,7837,-4378,16%,95-96,95-96 Milwaukee Bucks,12.87804878,66.26829268,79.14634146
1996,1995-96,Detroit Pistons,82,19830,2810,6122,46%,545,1350,40%,2265,4772,48%,7822,-3422,22%,95-96,95-96 Detroit Pistons,16.46341463,58.19512195,74.65853659
1996,1995-96,Philadelphia 76ers,82,19730,2796,6418,44%,492,1438,34%,2304,4980,46%,7746,-3542,22%,95-96,95-96 Philadelphia 76ers,17.53658537,60.73170732,78.26829268
1996,1995-96,New Jersey Nets,82,19905,2881,6750,43%,250,746,34%,2631,6004,44%,7684,-5258,11%,95-96,95-96 New Jersey Nets,9.097560976,73.2195122,82.31707317
1996,1995-96,Cleveland Cavaliers,82,19830,2761,5998,46%,596,1582,38%,2165,4416,49%,7473,-2834,26%,95-96,95-96 Cleveland Cavaliers,19.29268293,53.85365854,73.14634146
1996,1995-96,Vancouver Grizzlies,82,19880,2772,6483,43%,372,1129,33%,2400,5354,45%,7362,-4225,17%,95-96,95-96 Vancouver Grizzlies,13.76829268,65.29268293,79.06097561
1995,1994-95,Orlando Magic,82,19930,3460,6899,50%,523,1412,37%,2937,5487,54%,9091,-4075,20%,94-95,94-95 Orlando Magic,17.2195122,66.91463415,84.13414634
1995,1994-95,Phoenix Suns,82,19830,3356,6967,48%,584,1584,37%,2772,5383,52%,9073,-3799,23%,94-95,94-95 Phoenix Suns,19.31707317,65.64634146,84.96341463
1995,1994-95,Seattle SuperSonics,82,19830,3310,6741,49%,491,1305,38%,2819,5436,52%,9055,-4131,19%,94-95,94-95 Seattle SuperSonics,15.91463415,66.29268293,82.20731707
1995,1994-95,San Antonio Spurs,82,19855,3236,6687,48%,434,1158,38%,2802,5529,51%,8742,-4371,17%,94-95,94-95 San Antonio Spurs,14.12195122,67.42682927,81.54878049
1995,1994-95,Utah Jazz,82,19780,3243,6339,51%,301,801,38%,2942,5538,53%,8726,-4737,13%,94-95,94-95 Utah Jazz,9.768292683,67.53658537,77.30487805
1995,1994-95,Golden State Warriors,82,19905,3217,6873,47%,546,1602,34%,2671,5271,51%,8667,-3669,23%,94-95,94-95 Golden State Warriors,19.53658537,64.2804878,83.81707317
1995,1994-95,Los Angeles Lakers,82,19905,3284,7088,46%,525,1492,35%,2759,5596,49%,8616,-4104,21%,94-95,94-95 Los Angeles Lakers,18.19512195,68.24390244,86.43902439
1995,1994-95,Houston Rockets,82,19730,3159,6579,48%,646,1757,37%,2513,4822,52%,8491,-3065,27%,94-95,94-95 Houston Rockets,21.42682927,58.80487805,80.23170732
1995,1994-95,Dallas Mavericks,82,19930,3227,7342,44%,386,1200,32%,2841,6142,46%,8462,-4942,16%,94-95,94-95 Dallas Mavericks,14.63414634,74.90243902,89.53658537
1995,1994-95,Portland Trail Blazers,82,19705,3217,7134,45%,462,1266,37%,2755,5868,47%,8451,-4602,18%,94-95,94-95 Portland Trail Blazers,15.43902439,71.56097561,87
1995,1994-95,Boston Celtics,82,19805,3179,6847,46%,362,984,37%,2817,5863,48%,8428,-4879,14%,94-95,94-95 Boston Celtics,12,71.5,83.5
1995,1994-95,Chicago Bulls,82,19830,3191,6710,48%,443,1187,37%,2748,5523,50%,8325,-4336,18%,94-95,94-95 Chicago Bulls,14.47560976,67.35365854,81.82926829
1995,1994-95,Denver Nuggets,82,19980,3098,6461,48%,413,1160,36%,2685,5301,51%,8309,-4141,18%,94-95,94-95 Denver Nuggets,14.14634146,64.64634146,78.79268293
1995,1994-95,Miami Heat,82,19805,3144,6738,47%,436,1182,37%,2708,5556,49%,8293,-4374,18%,94-95,94-95 Miami Heat,14.41463415,67.75609756,82.17073171
1995,1994-95,Charlotte Hornets,82,19805,3051,6438,47%,560,1409,40%,2491,5029,50%,8249,-3620,22%,94-95,94-95 Charlotte Hornets,17.18292683,61.32926829,78.51219512
1995,1994-95,Washington Bullets,82,19855,3176,6899,46%,433,1264,34%,2743,5635,49%,8242,-4371,18%,94-95,94-95 Washington Bullets,15.41463415,68.7195122,84.13414634
1995,1994-95,Milwaukee Bucks,82,19855,3022,6586,46%,494,1349,37%,2528,5237,48%,8146,-3888,20%,94-95,94-95 Milwaukee Bucks,16.45121951,63.86585366,80.31707317
1995,1994-95,Indiana Pacers,82,19780,2983,6248,48%,374,985,38%,2609,5263,50%,8136,-4278,16%,94-95,94-95 Indiana Pacers,12.01219512,64.18292683,76.19512195
1995,1994-95,Sacramento Kings,82,19855,3025,6463,47%,359,1037,35%,2666,5426,49%,8056,-4389,16%,94-95,94-95 Sacramento Kings,12.64634146,66.17073171,78.81707317
1995,1994-95,New York Knicks,82,19780,2985,6394,47%,532,1446,37%,2453,4948,50%,8054,-3502,23%,94-95,94-95 New York Knicks,17.63414634,60.34146341,77.97560976
1995,1994-95,Detroit Pistons,82,19730,3060,6633,46%,494,1396,35%,2566,5237,49%,8053,-3841,21%,94-95,94-95 Detroit Pistons,17.02439024,63.86585366,80.8902439
1995,1994-95,New Jersey Nets,82,19880,2939,6738,44%,414,1297,32%,2525,5441,46%,8042,-4144,19%,94-95,94-95 New Jersey Nets,15.81707317,66.35365854,82.17073171
1995,1994-95,Los Angeles Clippers,82,19880,3060,6888,44%,331,1051,32%,2729,5837,47%,7927,-4786,15%,94-95,94-95 Los Angeles Clippers,12.81707317,71.18292683,84
1995,1994-95,Atlanta Hawks,82,19855,2986,6680,45%,539,1580,34%,2447,5100,48%,7921,-3520,24%,94-95,94-95 Atlanta Hawks,19.26829268,62.19512195,81.46341463
1995,1994-95,Philadelphia 76ers,82,19805,2949,6577,45%,355,936,38%,2594,5641,46%,7820,-4705,14%,94-95,94-95 Philadelphia 76ers,11.41463415,68.79268293,80.20731707
1995,1994-95,Minnesota Timberwolves,82,19780,2792,6219,45%,318,1016,31%,2474,5203,48%,7726,-4187,16%,94-95,94-95 Minnesota Timberwolves,12.3902439,63.45121951,75.84146341
1995,1994-95,Cleveland Cavaliers,82,19930,2756,6255,44%,398,1033,39%,2358,5222,45%,7417,-4189,17%,94-95,94-95 Cleveland Cavaliers,12.59756098,63.68292683,76.2804878
1994,1993-94,Phoenix Suns,82,19705,3429,7080,48%,344,1042,33%,3085,6038,51%,8876,-4996,15%,93-94,93-94 Phoenix Suns,12.70731707,73.63414634,86.34146341
1994,1993-94,Golden State Warriors,82,19780,3512,7145,49%,291,859,34%,3221,6286,51%,8844,-5427,12%,93-94,93-94 Golden State Warriors,10.47560976,76.65853659,87.13414634
1994,1993-94,Portland Trail Blazers,82,19755,3371,7427,45%,272,770,35%,3099,6657,47%,8795,-5887,10%,93-94,93-94 Portland Trail Blazers,9.390243902,81.18292683,90.57317073
1994,1993-94,Charlotte Hornets,82,19830,3382,7100,48%,336,916,37%,3046,6184,49%,8732,-5268,13%,93-94,93-94 Charlotte Hornets,11.17073171,75.41463415,86.58536585
1994,1993-94,Seattle SuperSonics,82,19730,3338,6901,48%,242,722,34%,3096,6179,50%,8687,-5457,10%,93-94,93-94 Seattle SuperSonics,8.804878049,75.35365854,84.15853659
1994,1993-94,Orlando Magic,82,19730,3341,6883,49%,394,1137,35%,2947,5746,51%,8666,-4609,17%,93-94,93-94 Orlando Magic,13.86585366,70.07317073,83.93902439
1994,1993-94,Miami Heat,82,19805,3197,6896,46%,337,997,34%,2860,5899,49%,8475,-4902,14%,93-94,93-94 Miami Heat,12.15853659,71.93902439,84.09756098
1994,1993-94,New Jersey Nets,82,19830,3169,7115,45%,223,683,33%,2946,6432,46%,8461,-5749,10%,93-94,93-94 New Jersey Nets,8.329268293,78.43902439,86.76829268
1994,1993-94,Los Angeles Clippers,82,19780,3343,7163,47%,252,831,30%,3091,6332,49%,8447,-5501,12%,93-94,93-94 Los Angeles Clippers,10.13414634,77.2195122,87.35365854
1994,1993-94,Utah Jazz,82,19830,3207,6729,48%,179,559,32%,3028,6170,49%,8354,-5611,8%,93-94,93-94 Utah Jazz,6.817073171,75.24390244,82.06097561
1994,1993-94,Atlanta Hawks,82,19755,3247,7039,46%,268,830,32%,2979,6209,48%,8318,-5379,12%,93-94,93-94 Atlanta Hawks,10.12195122,75.7195122,85.84146341
1994,1993-94,Cleveland Cavaliers,82,19855,3133,6731,47%,294,813,36%,2839,5918,48%,8296,-5105,12%,93-94,93-94 Cleveland Cavaliers,9.914634146,72.17073171,82.08536585
1994,1993-94,Houston Rockets,82,19780,3197,6733,48%,429,1285,33%,2768,5448,51%,8292,-4163,19%,93-94,93-94 Houston Rockets,15.67073171,66.43902439,82.1097561
1994,1993-94,Sacramento Kings,82,19755,3179,7027,45%,257,729,35%,2922,6298,46%,8291,-5569,10%,93-94,93-94 Sacramento Kings,8.890243902,76.80487805,85.69512195
1994,1993-94,Indiana Pacers,82,19755,3167,6516,49%,184,500,37%,2983,6016,50%,8280,-5516,8%,93-94,93-94 Indiana Pacers,6.097560976,73.36585366,79.46341463
1994,1993-94,Boston Celtics,82,19905,3333,7057,47%,138,477,29%,3195,6580,49%,8267,-6103,7%,93-94,93-94 Boston Celtics,5.817073171,80.24390244,86.06097561
1994,1993-94,Los Angeles Lakers,82,19755,3291,7316,45%,241,803,30%,3050,6513,47%,8233,-5710,11%,93-94,93-94 Los Angeles Lakers,9.792682927,79.42682927,89.2195122
1994,1993-94,Washington Bullets,82,19705,3195,6826,47%,221,744,30%,2974,6082,49%,8229,-5338,11%,93-94,93-94 Washington Bullets,9.073170732,74.17073171,83.24390244
1994,1993-94,Denver Nuggets,82,19755,3156,6781,47%,170,597,29%,2986,6184,48%,8221,-5587,9%,93-94,93-94 Denver Nuggets,7.280487805,75.41463415,82.69512195
1994,1993-94,San Antonio Spurs,82,19780,3178,6688,48%,249,714,35%,2929,5974,49%,8202,-5260,11%,93-94,93-94 San Antonio Spurs,8.707317073,72.85365854,81.56097561
1994,1993-94,New York Knicks,82,19755,3098,6735,46%,316,908,35%,2782,5827,48%,8076,-4919,13%,93-94,93-94 New York Knicks,11.07317073,71.06097561,82.13414634
1994,1993-94,Philadelphia 76ers,82,19805,3103,6819,46%,318,942,34%,2785,5877,47%,8033,-4935,14%,93-94,93-94 Philadelphia 76ers,11.48780488,71.67073171,83.15853659
1994,1993-94,Chicago Bulls,82,19780,3245,6815,48%,233,659,35%,3012,6156,49%,8033,-5497,10%,93-94,93-94 Chicago Bulls,8.036585366,75.07317073,83.1097561
1994,1993-94,Milwaukee Bucks,82,19705,3044,6807,45%,331,1019,33%,2713,5788,47%,7949,-4769,15%,93-94,93-94 Milwaukee Bucks,12.42682927,70.58536585,83.01219512
1994,1993-94,Detroit Pistons,82,19730,3169,7017,45%,358,1041,34%,2811,5976,47%,7949,-4935,15%,93-94,93-94 Detroit Pistons,12.69512195,72.87804878,85.57317073
1994,1993-94,Minnesota Timberwolves,82,19730,2985,6535,46%,183,557,33%,2802,5978,47%,7930,-5421,9%,93-94,93-94 Minnesota Timberwolves,6.792682927,72.90243902,79.69512195
1994,1993-94,Dallas Mavericks,82,19730,3055,7070,43%,241,773,31%,2814,6297,45%,7801,-5524,11%,93-94,93-94 Dallas Mavericks,9.426829268,76.79268293,86.2195122
1993,1992-93,Phoenix Suns,82,19730,3494,7093,49%,398,1095,36%,3096,5998,52%,9298,-4903,15%,92-93,92-93 Phoenix Suns,13.35365854,73.14634146,86.5
1993,1992-93,Charlotte Hornets,82,19755,3512,7210,49%,175,537,33%,3337,6673,50%,9030,-6136,7%,92-93,92-93 Charlotte Hornets,6.548780488,81.37804878,87.92682927
1993,1992-93,Golden State Warriors,82,19905,3474,7212,48%,298,852,35%,3176,6360,50%,9014,-5508,12%,92-93,92-93 Golden State Warriors,10.3902439,77.56097561,87.95121951
1993,1992-93,Portland Trail Blazers,82,19905,3361,7343,46%,275,843,33%,3086,6500,48%,8898,-5657,11%,92-93,92-93 Portland Trail Blazers,10.2804878,79.26829268,89.54878049
1993,1992-93,Seattle SuperSonics,82,19780,3473,7140,49%,218,610,36%,3255,6530,50%,8884,-5920,9%,92-93,92-93 Seattle SuperSonics,7.43902439,79.63414634,87.07317073
1993,1992-93,Sacramento Kings,82,19780,3360,7264,46%,262,788,33%,3098,6476,48%,8847,-5688,11%,92-93,92-93 Sacramento Kings,9.609756098,78.97560976,88.58536585
1993,1992-93,Indiana Pacers,82,19755,3371,7022,48%,257,789,33%,3114,6233,50%,8836,-5444,11%,92-93,92-93 Indiana Pacers,9.62195122,76.01219512,85.63414634
1993,1992-93,Cleveland Cavaliers,82,19830,3425,6887,50%,283,742,38%,3142,6145,51%,8832,-5403,11%,92-93,92-93 Cleveland Cavaliers,9.048780488,74.93902439,83.98780488
1993,1992-93,Atlanta Hawks,82,19830,3392,7272,47%,382,1076,36%,3010,6196,49%,8814,-5120,15%,92-93,92-93 Atlanta Hawks,13.12195122,75.56097561,88.68292683
1993,1992-93,Los Angeles Clippers,82,19805,3544,7329,48%,133,491,27%,3411,6838,50%,8783,-6347,7%,92-93,92-93 Los Angeles Clippers,5.987804878,83.3902439,89.37804878
1993,1992-93,Utah Jazz,82,19755,3336,6828,49%,130,414,31%,3206,6414,50%,8709,-6000,6%,92-93,92-93 Utah Jazz,5.048780488,78.2195122,83.26829268
1993,1992-93,Orlando Magic,82,19880,3257,6708,49%,317,889,36%,2940,5819,51%,8652,-4930,13%,92-93,92-93 Orlando Magic,10.84146341,70.96341463,81.80487805
1993,1992-93,San Antonio Spurs,82,19855,3311,6762,49%,236,692,34%,3075,6070,51%,8652,-5378,10%,92-93,92-93 San Antonio Spurs,8.43902439,74.02439024,82.46341463
1993,1992-93,Denver Nuggets,82,19830,3352,7282,46%,138,454,30%,3214,6828,47%,8626,-6374,6%,92-93,92-93 Denver Nuggets,5.536585366,83.26829268,88.80487805
1993,1992-93,Chicago Bulls,82,19830,3475,7205,48%,244,669,37%,3231,6536,49%,8625,-5867,9%,92-93,92-93 Chicago Bulls,8.158536585,79.70731707,87.86585366
1993,1992-93,Philadelphia 76ers,82,19930,3225,7075,46%,330,941,35%,2895,6134,47%,8556,-5193,13%,92-93,92-93 Philadelphia 76ers,11.47560976,74.80487805,86.2804878
1993,1992-93,Los Angeles Lakers,82,19830,3309,6994,47%,187,626,30%,3122,6368,49%,8546,-5742,9%,92-93,92-93 Los Angeles Lakers,7.634146341,77.65853659,85.29268293
1993,1992-93,Houston Rockets,82,19780,3280,6744,49%,387,1073,36%,2893,5671,51%,8531,-4598,16%,92-93,92-93 Houston Rockets,13.08536585,69.15853659,82.24390244
1993,1992-93,Boston Celtics,82,19780,3453,7093,49%,110,383,29%,3343,6710,50%,8502,-6327,5%,92-93,92-93 Boston Celtics,4.670731707,81.82926829,86.5
1993,1992-93,Miami Heat,82,20005,3127,6850,46%,333,940,35%,2794,5910,47%,8495,-4970,14%,92-93,92-93 Miami Heat,11.46341463,72.07317073,83.53658537
1993,1992-93,New Jersey Nets,82,19780,3272,7084,46%,155,488,32%,3117,6596,47%,8431,-6108,7%,92-93,92-93 New Jersey Nets,5.951219512,80.43902439,86.3902439
1993,1992-93,Milwaukee Bucks,82,19730,3268,6924,47%,312,936,33%,2956,5988,49%,8392,-5052,14%,92-93,92-93 Milwaukee Bucks,11.41463415,73.02439024,84.43902439
1993,1992-93,Washington Bullets,82,19805,3302,7065,47%,174,578,30%,3128,6487,48%,8353,-5909,8%,92-93,92-93 Washington Bullets,7.048780488,79.1097561,86.15853659
1993,1992-93,New York Knicks,82,19930,3209,6898,47%,193,604,32%,3016,6294,48%,8328,-5690,9%,92-93,92-93 New York Knicks,7.365853659,76.75609756,84.12195122
1993,1992-93,Detroit Pistons,82,19780,3267,7211,45%,292,908,32%,2975,6303,47%,8252,-5395,13%,92-93,92-93 Detroit Pistons,11.07317073,76.86585366,87.93902439
1993,1992-93,Dallas Mavericks,82,19730,3164,7271,44%,283,837,34%,2881,6434,45%,8141,-5597,12%,92-93,92-93 Dallas Mavericks,10.20731707,78.46341463,88.67073171
1993,1992-93,Minnesota Timberwolves,82,19855,3043,6529,47%,166,569,29%,2877,5960,48%,8046,-5391,9%,92-93,92-93 Minnesota Timberwolves,6.93902439,72.68292683,79.62195122
1992,1991-92,Golden State Warriors,82,19880,3767,7427,51%,254,763,33%,3513,6664,53%,9732,-5901,10%,91-92,91-92 Golden State Warriors,9.304878049,81.26829268,90.57317073
1992,1991-92,Indiana Pacers,82,19955,3498,7079,49%,333,940,35%,3165,6139,52%,9197,-5199,13%,91-92,91-92 Indiana Pacers,11.46341463,74.86585366,86.32926829
1992,1991-92,Phoenix Suns,82,19805,3553,7219,49%,227,596,38%,3326,6623,50%,9194,-6027,8%,91-92,91-92 Phoenix Suns,7.268292683,80.76829268,88.03658537
1992,1991-92,Portland Trail Blazers,82,19880,3476,7352,47%,325,944,34%,3151,6408,49%,9135,-5464,13%,91-92,91-92 Portland Trail Blazers,11.51219512,78.14634146,89.65853659
1992,1991-92,Chicago Bulls,82,19830,3643,7168,51%,138,454,30%,3505,6714,52%,9011,-6260,6%,91-92,91-92 Chicago Bulls,5.536585366,81.87804878,87.41463415
1992,1991-92,Charlotte Hornets,82,19805,3613,7568,48%,117,369,32%,3496,7199,49%,8980,-6830,5%,91-92,91-92 Charlotte Hornets,4.5,87.79268293,92.29268293
1992,1991-92,Cleveland Cavaliers,82,19805,3427,7025,49%,253,708,36%,3174,6317,50%,8926,-5609,10%,91-92,91-92 Cleveland Cavaliers,8.634146341,77.03658537,85.67073171
1992,1991-92,Utah Jazz,82,19880,3379,6866,49%,158,458,35%,3221,6408,50%,8877,-5950,7%,91-92,91-92 Utah Jazz,5.585365854,78.14634146,83.73170732
1992,1991-92,Boston Celtics,82,19780,3543,7196,49%,110,359,31%,3433,6837,50%,8745,-6478,5%,91-92,91-92 Boston Celtics,4.37804878,83.37804878,87.75609756
1992,1991-92,Seattle SuperSonics,82,19855,3380,7128,47%,205,647,32%,3175,6481,49%,8737,-5834,9%,91-92,91-92 Seattle SuperSonics,7.890243902,79.03658537,86.92682927
1992,1991-92,Atlanta Hawks,82,19905,3492,7476,47%,210,671,31%,3282,6805,48%,8711,-6134,9%,91-92,91-92 Atlanta Hawks,8.182926829,82.98780488,91.17073171
1992,1991-92,New Jersey Nets,82,19780,3473,7580,46%,224,670,33%,3249,6910,47%,8641,-6240,9%,91-92,91-92 New Jersey Nets,8.170731707,84.26829268,92.43902439
1992,1991-92,Milwaukee Bucks,82,19880,3321,7216,46%,371,1005,37%,2950,6211,48%,8609,-5206,14%,91-92,91-92 Milwaukee Bucks,12.25609756,75.74390244,88
1992,1991-92,Miami Heat,82,19830,3256,7061,46%,257,751,34%,2999,6310,48%,8608,-5559,11%,91-92,91-92 Miami Heat,9.158536585,76.95121951,86.1097561
1992,1991-92,Sacramento Kings,82,19830,3348,7189,47%,238,675,35%,3110,6514,48%,8549,-5839,9%,91-92,91-92 Sacramento Kings,8.231707317,79.43902439,87.67073171
1992,1991-92,San Antonio Spurs,82,19780,3377,7090,48%,118,404,29%,3259,6686,49%,8524,-6282,6%,91-92,91-92 San Antonio Spurs,4.926829268,81.53658537,86.46341463
1992,1991-92,Los Angeles Clippers,82,19830,3347,7076,47%,145,502,29%,3202,6574,49%,8440,-6072,7%,91-92,91-92 Los Angeles Clippers,6.12195122,80.17073171,86.29268293
1992,1991-92,Washington Bullets,82,19855,3364,7301,46%,146,537,27%,3218,6764,48%,8395,-6227,7%,91-92,91-92 Washington Bullets,6.548780488,82.48780488,89.03658537
1992,1991-92,Houston Rockets,82,19880,3273,6894,48%,329,959,34%,2944,5935,50%,8366,-4976,14%,91-92,91-92 Houston Rockets,11.69512195,72.37804878,84.07317073
1992,1991-92,Philadelphia 76ers,82,19755,3187,6761,47%,227,680,33%,2960,6081,49%,8358,-5401,10%,91-92,91-92 Philadelphia 76ers,8.292682927,74.15853659,82.45121951
1992,1991-92,Orlando Magic,82,19705,3220,7102,45%,197,608,32%,3023,6494,47%,8330,-5886,9%,91-92,91-92 Orlando Magic,7.414634146,79.19512195,86.6097561
1992,1991-92,New York Knicks,82,19855,3312,6947,48%,201,618,33%,3111,6329,49%,8328,-5711,9%,91-92,91-92 New York Knicks,7.536585366,77.18292683,84.7195122
1992,1991-92,Minnesota Timberwolves,82,19805,3366,7342,46%,126,394,32%,3240,6948,47%,8237,-6554,5%,91-92,91-92 Minnesota Timberwolves,4.804878049,84.73170732,89.53658537
1992,1991-92,Los Angeles Lakers,82,19830,3183,6977,46%,119,445,27%,3064,6532,47%,8229,-6087,6%,91-92,91-92 Los Angeles Lakers,5.426829268,79.65853659,85.08536585
1992,1991-92,Denver Nuggets,82,19780,3262,7380,44%,126,418,30%,3136,6962,45%,8176,-6544,6%,91-92,91-92 Denver Nuggets,5.097560976,84.90243902,90
1992,1991-92,Detroit Pistons,82,19780,3191,6867,47%,165,526,31%,3026,6341,48%,8113,-5815,8%,91-92,91-92 Detroit Pistons,6.414634146,77.32926829,83.74390244
1992,1991-92,Dallas Mavericks,82,19755,3120,7104,44%,268,797,34%,2852,6307,45%,8007,-5510,11%,91-92,91-92 Dallas Mavericks,9.719512195,76.91463415,86.63414634
1991,1990-91,Denver Nuggets,82,19730,3901,8868,44%,300,1059,28%,3601,7809,46%,9828,-6750,12%,90-91,90-91 Denver Nuggets,12.91463415,95.23170732,108.1463415
1991,1990-91,Golden State Warriors,82,19805,3566,7346,49%,270,801,34%,3296,6545,50%,9564,-5744,11%,90-91,90-91 Golden State Warriors,9.768292683,79.81707317,89.58536585
1991,1990-91,Portland Trail Blazers,82,19905,3577,7369,49%,341,904,38%,3236,6465,50%,9407,-5561,12%,90-91,90-91 Portland Trail Blazers,11.02439024,78.84146341,89.86585366
1991,1990-91,Phoenix Suns,82,19730,3573,7199,50%,138,432,32%,3435,6767,51%,9348,-6335,6%,90-91,90-91 Phoenix Suns,5.268292683,82.52439024,87.79268293
1991,1990-91,Indiana Pacers,82,19805,3450,6994,49%,249,749,33%,3201,6245,51%,9159,-5496,11%,90-91,90-91 Indiana Pacers,9.134146341,76.15853659,85.29268293
1991,1990-91,Boston Celtics,82,19805,3695,7214,51%,109,346,32%,3586,6868,52%,9145,-6522,5%,90-91,90-91 Boston Celtics,4.219512195,83.75609756,87.97560976
1991,1990-91,Chicago Bulls,82,19755,3632,7125,51%,155,424,37%,3477,6701,52%,9024,-6277,6%,90-91,90-91 Chicago Bulls,5.170731707,81.7195122,86.8902439
1991,1990-91,Atlanta Hawks,82,19755,3349,7223,46%,271,836,32%,3078,6387,48%,9003,-5551,12%,90-91,90-91 Atlanta Hawks,10.19512195,77.8902439,88.08536585
1991,1990-91,San Antonio Spurs,82,19830,3409,6988,49%,81,297,27%,3328,6691,50%,8782,-6394,4%,90-91,90-91 San Antonio Spurs,3.62195122,81.59756098,85.2195122
1991,1990-91,Houston Rockets,82,19855,3403,7287,47%,316,989,32%,3087,6298,49%,8753,-5309,14%,90-91,90-91 Houston Rockets,12.06097561,76.80487805,88.86585366
1991,1990-91,Seattle SuperSonics,82,19880,3500,7117,49%,136,427,32%,3364,6690,50%,8744,-6263,6%,90-91,90-91 Seattle SuperSonics,5.207317073,81.58536585,86.79268293
1991,1990-91,Milwaukee Bucks,82,19855,3337,6948,48%,257,753,34%,3080,6195,50%,8727,-5442,11%,90-91,90-91 Milwaukee Bucks,9.182926829,75.54878049,84.73170732
1991,1990-91,Los Angeles Lakers,82,19830,3343,6911,48%,226,744,30%,3117,6167,51%,8717,-5423,11%,90-91,90-91 Los Angeles Lakers,9.073170732,75.20731707,84.2804878
1991,1990-91,Orlando Magic,82,19780,3298,7256,46%,270,754,36%,3028,6502,47%,8684,-5748,10%,90-91,90-91 Orlando Magic,9.195121951,79.29268293,88.48780488
1991,1990-91,Philadelphia 76ers,82,20080,3289,6925,48%,195,618,32%,3094,6307,49%,8641,-5689,9%,90-91,90-91 Philadelphia 76ers,7.536585366,76.91463415,84.45121951
1991,1990-91,Utah Jazz,82,19780,3214,6537,49%,148,458,32%,3066,6079,50%,8527,-5621,7%,90-91,90-91 Utah Jazz,5.585365854,74.13414634,79.7195122
1991,1990-91,Los Angeles Clippers,82,19805,3391,7315,46%,113,434,26%,3278,6881,48%,8491,-6447,6%,90-91,90-91 Los Angeles Clippers,5.292682927,83.91463415,89.20731707
1991,1990-91,New York Knicks,82,19955,3308,6822,49%,185,558,33%,3123,6264,50%,8455,-5706,8%,90-91,90-91 New York Knicks,6.804878049,76.3902439,83.19512195
1991,1990-91,New Jersey Nets,82,19830,3311,7459,44%,161,586,28%,3150,6873,46%,8441,-6287,8%,90-91,90-91 New Jersey Nets,7.146341463,83.81707317,90.96341463
1991,1990-91,Charlotte Hornets,82,19805,3286,7033,47%,131,417,31%,3155,6616,48%,8428,-6199,6%,90-91,90-91 Charlotte Hornets,5.085365854,80.68292683,85.76829268
1991,1990-91,Miami Heat,82,19780,3280,7139,46%,140,464,30%,3140,6675,47%,8349,-6211,6%,90-91,90-91 Miami Heat,5.658536585,81.40243902,87.06097561
1991,1990-91,Cleveland Cavaliers,82,19830,3259,6857,48%,160,479,33%,3099,6378,49%,8343,-5899,7%,90-91,90-91 Cleveland Cavaliers,5.841463415,77.7804878,83.62195122
1991,1990-91,Washington Bullets,82,19855,3390,7268,47%,55,284,19%,3335,6984,48%,8313,-6700,4%,90-91,90-91 Washington Bullets,3.463414634,85.17073171,88.63414634
1991,1990-91,Detroit Pistons,82,19805,3194,6875,47%,131,440,30%,3063,6435,48%,8205,-5995,6%,90-91,90-91 Detroit Pistons,5.365853659,78.47560976,83.84146341
1991,1990-91,Dallas Mavericks,82,19805,3245,6890,47%,193,600,32%,3052,6290,49%,8195,-5690,9%,90-91,90-91 Dallas Mavericks,7.317073171,76.70731707,84.02439024
1991,1990-91,Minnesota Timberwolves,82,19905,3265,7276,45%,108,381,28%,3157,6895,46%,8169,-6514,5%,90-91,90-91 Minnesota Timberwolves,4.646341463,84.08536585,88.73170732
1991,1990-91,Sacramento Kings,82,19705,3086,6818,45%,216,578,37%,2870,6240,46%,7928,-5662,8%,90-91,90-91 Sacramento Kings,7.048780488,76.09756098,83.14634146
1990,1989-90,Golden State Warriors,82,19705,3489,7208,48%,243,750,32%,3246,6458,50%,9534,-5708,10%,89-90,89-90 Golden State Warriors,9.146341463,78.75609756,87.90243902
1990,1989-90,Phoenix Suns,82,19855,3544,7139,50%,176,543,32%,3368,6596,51%,9423,-6053,8%,89-90,89-90 Phoenix Suns,6.62195122,80.43902439,87.06097561
1990,1989-90,Denver Nuggets,82,19805,3716,8015,46%,228,677,34%,3488,7338,48%,9397,-6661,8%,89-90,89-90 Denver Nuggets,8.256097561,89.48780488,97.74390244
1990,1989-90,Portland Trail Blazers,82,19880,3572,7547,47%,190,565,34%,3382,6982,48%,9365,-6417,7%,89-90,89-90 Portland Trail Blazers,6.890243902,85.14634146,92.03658537
1990,1989-90,Orlando Magic,82,19805,3457,7525,46%,116,393,30%,3341,7132,47%,9090,-6739,5%,89-90,89-90 Orlando Magic,4.792682927,86.97560976,91.76829268
1990,1989-90,Los Angeles Lakers,82,19855,3434,7010,49%,309,841,37%,3125,6169,51%,9079,-5328,12%,89-90,89-90 Los Angeles Lakers,10.25609756,75.23170732,85.48780488
1990,1989-90,Philadelphia 76ers,82,19805,3437,7028,49%,189,543,35%,3248,6485,50%,9039,-5942,8%,89-90,89-90 Philadelphia 76ers,6.62195122,79.08536585,85.70731707
1990,1989-90,Boston Celtics,82,19705,3563,7148,50%,106,404,26%,3457,6744,51%,9023,-6340,6%,89-90,89-90 Boston Celtics,4.926829268,82.24390244,87.17073171
1990,1989-90,Chicago Bulls,82,19830,3531,7090,50%,250,669,37%,3281,6421,51%,8977,-5752,9%,89-90,89-90 Chicago Bulls,8.158536585,78.30487805,86.46341463
1990,1989-90,Indiana Pacers,82,19880,3381,6807,50%,294,770,38%,3087,6037,51%,8962,-5267,11%,89-90,89-90 Indiana Pacers,9.390243902,73.62195122,83.01219512
1990,1989-90,Atlanta Hawks,82,19730,3417,7019,49%,124,411,30%,3293,6608,50%,8901,-6197,6%,89-90,89-90 Atlanta Hawks,5.012195122,80.58536585,85.59756098
1990,1989-90,New York Knicks,82,19830,3434,7089,48%,236,710,33%,3198,6379,50%,8879,-5669,10%,89-90,89-90 New York Knicks,8.658536585,77.79268293,86.45121951
1990,1989-90,Washington Bullets,82,19830,3598,7581,48%,37,197,19%,3561,7384,48%,8832,-7187,3%,89-90,89-90 Washington Bullets,2.402439024,90.04878049,92.45121951
1990,1989-90,Seattle SuperSonics,82,19905,3466,7243,48%,231,650,36%,3235,6593,49%,8769,-5943,9%,89-90,89-90 Seattle SuperSonics,7.926829268,80.40243902,88.32926829
1990,1989-90,Utah Jazz,82,19830,3330,6593,51%,226,630,36%,3104,5963,52%,8760,-5333,10%,89-90,89-90 Utah Jazz,7.682926829,72.7195122,80.40243902
1990,1989-90,Houston Rockets,82,19805,3483,7250,48%,153,491,31%,3330,6759,49%,8752,-6268,7%,89-90,89-90 Houston Rockets,5.987804878,82.42682927,88.41463415
1990,1989-90,San Antonio Spurs,82,19730,3388,6997,48%,54,226,24%,3334,6771,49%,8718,-6545,3%,89-90,89-90 San Antonio Spurs,2.756097561,82.57317073,85.32926829
1990,1989-90,Milwaukee Bucks,82,19830,3380,7146,47%,209,670,31%,3171,6476,49%,8691,-5806,9%,89-90,89-90 Milwaukee Bucks,8.170731707,78.97560976,87.14634146
1990,1989-90,Detroit Pistons,82,19805,3333,6980,48%,177,541,33%,3156,6439,49%,8556,-5898,8%,89-90,89-90 Detroit Pistons,6.597560976,78.52439024,85.12195122
1990,1989-90,Los Angeles Clippers,82,19805,3319,6853,48%,56,230,24%,3263,6623,49%,8509,-6393,3%,89-90,89-90 Los Angeles Clippers,2.804878049,80.76829268,83.57317073
1990,1989-90,Cleveland Cavaliers,82,19880,3214,6977,46%,346,851,41%,2868,6126,47%,8411,-5275,12%,89-90,89-90 Cleveland Cavaliers,10.37804878,74.70731707,85.08536585
1990,1989-90,Dallas Mavericks,82,19855,3246,6831,48%,157,486,32%,3089,6345,49%,8384,-5859,7%,89-90,89-90 Dallas Mavericks,5.926829268,77.37804878,83.30487805
1990,1989-90,Sacramento Kings,82,19755,3305,7056,47%,216,649,33%,3089,6407,48%,8341,-5758,9%,89-90,89-90 Sacramento Kings,7.914634146,78.13414634,86.04878049
1990,1989-90,Miami Heat,82,19730,3383,7345,46%,88,300,29%,3295,7045,47%,8247,-6745,4%,89-90,89-90 Miami Heat,3.658536585,85.91463415,89.57317073
1990,1989-90,Charlotte Hornets,82,19755,3270,7183,46%,205,611,34%,3065,6572,47%,8232,-5961,9%,89-90,89-90 Charlotte Hornets,7.451219512,80.14634146,87.59756098
1990,1989-90,New Jersey Nets,82,19705,3157,7415,43%,140,506,28%,3017,6909,44%,8208,-6403,7%,89-90,89-90 New Jersey Nets,6.170731707,84.25609756,90.42682927
1990,1989-90,Minnesota Timberwolves,82,19855,3067,6876,45%,73,294,25%,2994,6582,46%,7803,-6288,4%,89-90,89-90 Minnesota Timberwolves,3.585365854,80.26829268,83.85365854
1989,1988-89,Phoenix Suns,82,19755,3754,7545,50%,168,481,35%,3586,7064,51%,9727,-6583,6%,88-89,88-89 Phoenix Suns,5.865853659,86.14634146,92.01219512
1989,1988-89,Denver Nuggets,82,19880,3813,8140,47%,228,676,34%,3585,7464,48%,9675,-6788,8%,88-89,88-89 Denver Nuggets,8.243902439,91.02439024,99.26829268
1989,1988-89,New York Knicks,82,19805,3701,7611,49%,386,1147,34%,3315,6464,51%,9567,-5317,15%,88-89,88-89 New York Knicks,13.98780488,78.82926829,92.81707317
1989,1988-89,Golden State Warriors,82,19905,3730,7977,47%,194,629,31%,3536,7348,48%,9558,-6719,8%,88-89,88-89 Golden State Warriors,7.670731707,89.6097561,97.2804878
1989,1988-89,Los Angeles Lakers,82,19805,3584,7143,50%,227,667,34%,3357,6476,52%,9406,-5809,9%,88-89,88-89 Los Angeles Lakers,8.134146341,78.97560976,87.1097561
1989,1988-89,Portland Trail Blazers,82,19830,3695,7795,47%,216,645,34%,3479,7150,49%,9395,-6505,8%,88-89,88-89 Portland Trail Blazers,7.865853659,87.19512195,95.06097561
1989,1988-89,Seattle SuperSonics,82,19780,3564,7478,48%,293,774,38%,3271,6704,49%,9196,-5930,10%,88-89,88-89 Seattle SuperSonics,9.43902439,81.75609756,91.19512195
1989,1988-89,Philadelphia 76ers,82,19780,3500,7201,49%,204,646,32%,3296,6555,50%,9174,-5909,9%,88-89,88-89 Philadelphia 76ers,7.87804878,79.93902439,87.81707317
1989,1988-89,Atlanta Hawks,82,19805,3412,7230,47%,110,397,28%,3302,6833,48%,9102,-6436,5%,88-89,88-89 Atlanta Hawks,4.841463415,83.32926829,88.17073171
1989,1988-89,Boston Celtics,82,19780,3520,7143,49%,78,309,25%,3442,6834,50%,8958,-6525,4%,88-89,88-89 Boston Celtics,3.768292683,83.34146341,87.1097561
1989,1988-89,Milwaukee Bucks,82,19755,3399,7167,47%,179,567,32%,3220,6600,49%,8932,-6033,8%,88-89,88-89 Milwaukee Bucks,6.914634146,80.48780488,87.40243902
1989,1988-89,Cleveland Cavaliers,82,19755,3466,6904,50%,170,474,36%,3296,6430,51%,8923,-5956,7%,88-89,88-89 Cleveland Cavaliers,5.780487805,78.41463415,84.19512195
1989,1988-89,Houston Rockets,82,19855,3412,7196,47%,164,523,31%,3248,6673,49%,8897,-6150,7%,88-89,88-89 Houston Rockets,6.37804878,81.37804878,87.75609756
1989,1988-89,Washington Bullets,82,19855,3519,7591,46%,52,243,21%,3467,7348,47%,8879,-7105,3%,88-89,88-89 Washington Bullets,2.963414634,89.6097561,92.57317073
1989,1988-89,Indiana Pacers,82,19855,3385,6945,49%,202,615,33%,3183,6330,50%,8767,-5715,9%,88-89,88-89 Indiana Pacers,7.5,77.19512195,84.69512195
1989,1988-89,Detroit Pistons,82,19830,3395,6879,49%,120,400,30%,3275,6479,51%,8740,-6079,6%,88-89,88-89 Detroit Pistons,4.87804878,79.01219512,83.8902439
1989,1988-89,Chicago Bulls,82,19780,3448,6968,50%,174,530,33%,3274,6438,51%,8726,-5908,8%,88-89,88-89 Chicago Bulls,6.463414634,78.51219512,84.97560976
1989,1988-89,Los Angeles Clippers,82,19855,3526,7428,48%,54,234,23%,3472,7194,48%,8712,-6960,3%,88-89,88-89 Los Angeles Clippers,2.853658537,87.73170732,90.58536585
1989,1988-89,San Antonio Spurs,82,19755,3469,7409,47%,63,293,22%,3406,7116,48%,8652,-6823,4%,88-89,88-89 San Antonio Spurs,3.573170732,86.7804878,90.35365854
1989,1988-89,Sacramento Kings,82,19780,3362,7351,46%,307,824,37%,3055,6527,47%,8651,-5703,11%,88-89,88-89 Sacramento Kings,10.04878049,79.59756098,89.64634146
1989,1988-89,Utah Jazz,82,19730,3182,6595,48%,114,380,30%,3068,6215,49%,8588,-5835,6%,88-89,88-89 Utah Jazz,4.634146341,75.79268293,80.42682927
1989,1988-89,Charlotte Hornets,82,19780,3426,7430,46%,134,430,31%,3292,7000,47%,8566,-6570,6%,88-89,88-89 Charlotte Hornets,5.243902439,85.36585366,90.6097561
1989,1988-89,New Jersey Nets,82,19805,3333,7226,46%,187,568,33%,3146,6658,47%,8506,-6090,8%,88-89,88-89 New Jersey Nets,6.926829268,81.19512195,88.12195122
1989,1988-89,Dallas Mavericks,82,19780,3244,6917,47%,211,681,31%,3033,6236,49%,8484,-5555,10%,88-89,88-89 Dallas Mavericks,8.304878049,76.04878049,84.35365854
1989,1988-89,Miami Heat,82,19855,3221,7116,45%,97,298,33%,3124,6818,46%,8016,-6520,4%,88-89,88-89 Miami Heat,3.634146341,83.14634146,86.7804878
1988,1987-88,Denver Nuggets,82,19780,3770,7961,47%,192,562,34%,3578,7399,48%,9573,-6837,7%,87-88,87-88 Denver Nuggets,6.853658537,90.23170732,97.08536585
1988,1987-88,Portland Trail Blazers,82,19730,3661,7460,49%,117,380,31%,3544,7080,50%,9518,-6700,5%,87-88,87-88 Portland Trail Blazers,4.634146341,86.34146341,90.97560976
1988,1987-88,Boston Celtics,82,19780,3599,6905,52%,271,705,38%,3328,6200,54%,9315,-5495,10%,87-88,87-88 Boston Celtics,8.597560976,75.6097561,84.20731707
1988,1987-88,San Antonio Spurs,82,19805,3706,7559,49%,133,412,32%,3573,7147,50%,9314,-6735,5%,87-88,87-88 San Antonio Spurs,5.024390244,87.15853659,92.18292683
1988,1987-88,Los Angeles Lakers,82,19805,3576,7078,51%,142,478,30%,3434,6600,52%,9250,-6122,7%,87-88,87-88 Los Angeles Lakers,5.829268293,80.48780488,86.31707317
1988,1987-88,Seattle SuperSonics,82,19855,3544,7443,48%,221,638,35%,3323,6805,49%,9135,-6167,9%,87-88,87-88 Seattle SuperSonics,7.780487805,82.98780488,90.76829268
1988,1987-88,Dallas Mavericks,82,19755,3413,7191,48%,154,526,29%,3259,6665,49%,8960,-6139,7%,87-88,87-88 Dallas Mavericks,6.414634146,81.2804878,87.69512195
1988,1987-88,Detroit Pistons,82,19780,3461,7018,49%,58,202,29%,3403,6816,50%,8957,-6614,3%,87-88,87-88 Detroit Pistons,2.463414634,83.12195122,85.58536585
1988,1987-88,Houston Rockets,82,19680,3465,7354,47%,69,291,24%,3396,7063,48%,8935,-6772,4%,87-88,87-88 Houston Rockets,3.548780488,86.13414634,89.68292683
1988,1987-88,Phoenix Suns,82,19730,3551,7302,49%,118,357,33%,3433,6945,49%,8901,-6588,5%,87-88,87-88 Phoenix Suns,4.353658537,84.69512195,89.04878049
1988,1987-88,Utah Jazz,82,19705,3484,7092,49%,129,404,32%,3355,6688,50%,8899,-6284,6%,87-88,87-88 Utah Jazz,4.926829268,81.56097561,86.48780488
1988,1987-88,Sacramento Kings,82,19780,3458,7337,47%,144,450,32%,3314,6887,48%,8855,-6437,6%,87-88,87-88 Sacramento Kings,5.487804878,83.98780488,89.47560976
1988,1987-88,Atlanta Hawks,82,19780,3443,7102,49%,85,282,30%,3358,6820,49%,8844,-6538,4%,87-88,87-88 Atlanta Hawks,3.43902439,83.17073171,86.6097561
1988,1987-88,Golden State Warriors,82,19780,3463,7404,47%,91,312,29%,3372,7092,48%,8771,-6780,4%,87-88,87-88 Golden State Warriors,3.804878049,86.48780488,90.29268293
1988,1987-88,Milwaukee Bucks,82,19780,3366,7079,48%,133,410,32%,3233,6669,49%,8697,-6259,6%,87-88,87-88 Milwaukee Bucks,5,81.32926829,86.32926829
1988,1987-88,Philadelphia 76ers,82,19905,3214,6785,47%,152,471,32%,3062,6314,49%,8667,-5843,7%,87-88,87-88 Philadelphia 76ers,5.743902439,77,82.74390244
1988,1987-88,New York Knicks,82,19805,3363,7232,47%,179,567,32%,3184,6665,48%,8655,-6098,8%,87-88,87-88 New York Knicks,6.914634146,81.2804878,88.19512195
1988,1987-88,Washington Bullets,82,19880,3355,7164,47%,29,138,21%,3326,7026,47%,8653,-6888,2%,87-88,87-88 Washington Bullets,1.682926829,85.68292683,87.36585366
1988,1987-88,Chicago Bulls,82,19855,3434,7015,49%,56,243,23%,3378,6772,50%,8609,-6529,3%,87-88,87-88 Chicago Bulls,2.963414634,82.58536585,85.54878049
1988,1987-88,Indiana Pacers,82,19705,3436,7154,48%,163,485,34%,3273,6669,49%,8581,-6184,7%,87-88,87-88 Indiana Pacers,5.914634146,81.32926829,87.24390244
1988,1987-88,Cleveland Cavaliers,82,19780,3313,6755,49%,127,336,38%,3186,6419,50%,8566,-6083,5%,87-88,87-88 Cleveland Cavaliers,4.097560976,78.2804878,82.37804878
1988,1987-88,New Jersey Nets,82,19780,3208,6857,47%,137,455,30%,3071,6402,48%,8235,-5947,7%,87-88,87-88 New Jersey Nets,5.548780488,78.07317073,83.62195122
1988,1987-88,Los Angeles Clippers,82,19805,3190,7194,44%,79,317,25%,3111,6877,45%,8103,-6560,4%,87-88,87-88 Los Angeles Clippers,3.865853659,83.86585366,87.73170732
1987,1986-87,Portland Trail Blazers,82,19805,3650,7249,50%,98,339,29%,3552,6910,51%,9667,-6571,5%,86-87,86-87 Portland Trail Blazers,4.134146341,84.26829268,88.40243902
1987,1986-87,Los Angeles Lakers,82,19730,3740,7245,52%,164,447,37%,3576,6798,53%,9656,-6351,6%,86-87,86-87 Los Angeles Lakers,5.451219512,82.90243902,88.35365854
1987,1986-87,Denver Nuggets,82,19780,3744,7951,47%,106,391,27%,3638,7560,48%,9569,-7169,5%,86-87,86-87 Denver Nuggets,4.768292683,92.19512195,96.96341463
1987,1986-87,Dallas Mavericks,82,19880,3594,7373,49%,231,653,35%,3363,6720,50%,9567,-6067,9%,86-87,86-87 Dallas Mavericks,7.963414634,81.95121951,89.91463415
1987,1986-87,Seattle SuperSonics,82,19855,3593,7451,48%,191,571,34%,3402,6880,49%,9325,-6309,8%,86-87,86-87 Seattle SuperSonics,6.963414634,83.90243902,90.86585366
1987,1986-87,Boston Celtics,82,19805,3645,7051,52%,207,565,37%,3438,6486,53%,9237,-5921,8%,86-87,86-87 Boston Celtics,6.890243902,79.09756098,85.98780488
1987,1986-87,Golden State Warriors,82,19905,3551,7412,48%,116,364,32%,3435,7048,49%,9188,-6684,5%,86-87,86-87 Golden State Warriors,4.43902439,85.95121951,90.3902439
1987,1986-87,Detroit Pistons,82,19830,3544,7237,49%,39,169,23%,3505,7068,50%,9118,-6899,2%,86-87,86-87 Detroit Pistons,2.06097561,86.19512195,88.25609756
1987,1986-87,Phoenix Suns,82,19855,3575,7190,50%,61,252,24%,3514,6938,51%,9111,-6686,4%,86-87,86-87 Phoenix Suns,3.073170732,84.6097561,87.68292683
1987,1986-87,Sacramento Kings,82,19780,3522,7413,48%,77,307,25%,3445,7106,49%,9095,-6799,4%,86-87,86-87 Sacramento Kings,3.743902439,86.65853659,90.40243902
1987,1986-87,Milwaukee Bucks,82,19780,3457,7282,48%,185,572,32%,3272,6710,49%,9052,-6138,8%,86-87,86-87 Milwaukee Bucks,6.975609756,81.82926829,88.80487805
1987,1986-87,Atlanta Hawks,82,19730,3435,7141,48%,135,425,32%,3300,6716,49%,9024,-6291,6%,86-87,86-87 Atlanta Hawks,5.182926829,81.90243902,87.08536585
1987,1986-87,New Jersey Nets,82,19855,3374,7083,48%,145,449,32%,3229,6634,49%,8893,-6185,6%,86-87,86-87 New Jersey Nets,5.475609756,80.90243902,86.37804878
1987,1986-87,San Antonio Spurs,82,19805,3532,7456,47%,117,403,29%,3415,7053,48%,8882,-6650,5%,86-87,86-87 San Antonio Spurs,4.914634146,86.01219512,90.92682927
1987,1986-87,Utah Jazz,82,19755,3485,7514,46%,139,448,31%,3346,7066,47%,8844,-6618,6%,86-87,86-87 Utah Jazz,5.463414634,86.17073171,91.63414634
1987,1986-87,Houston Rockets,82,19780,3465,7262,48%,89,324,28%,3376,6938,49%,8765,-6614,4%,86-87,86-87 Houston Rockets,3.951219512,84.6097561,88.56097561
1987,1986-87,Philadelphia 76ers,82,19880,3335,6792,49%,88,340,26%,3247,6452,50%,8729,-6112,5%,86-87,86-87 Philadelphia 76ers,4.146341463,78.68292683,82.82926829
1987,1986-87,Indiana Pacers,82,19930,3454,7324,47%,94,316,30%,3360,7008,48%,8698,-6692,4%,86-87,86-87 Indiana Pacers,3.853658537,85.46341463,89.31707317
1987,1986-87,Washington Bullets,82,19705,3356,7397,45%,43,218,20%,3313,7179,46%,8690,-6961,3%,86-87,86-87 Washington Bullets,2.658536585,87.54878049,90.20731707
1987,1986-87,Chicago Bulls,82,19830,3382,7155,47%,78,299,26%,3304,6856,48%,8596,-6557,4%,86-87,86-87 Chicago Bulls,3.646341463,83.6097561,87.25609756
1987,1986-87,Los Angeles Clippers,82,19780,3311,7332,45%,78,348,22%,3233,6984,46%,8566,-6636,5%,86-87,86-87 Los Angeles Clippers,4.243902439,85.17073171,89.41463415
1987,1986-87,Cleveland Cavaliers,82,19755,3349,7122,47%,81,338,24%,3268,6784,48%,8558,-6446,5%,86-87,86-87 Cleveland Cavaliers,4.12195122,82.73170732,86.85365854
1987,1986-87,New York Knicks,82,19780,3329,7023,47%,125,375,33%,3204,6648,48%,8508,-6273,5%,86-87,86-87 New York Knicks,4.573170732,81.07317073,85.64634146
1986,1985-86,Los Angeles Lakers,82,19830,3834,7343,52%,138,409,34%,3696,6934,53%,9618,-6525,6%,85-86,85-86 Los Angeles Lakers,4.987804878,84.56097561,89.54878049
1986,1985-86,Dallas Mavericks,82,19805,3631,7254,50%,141,446,32%,3490,6808,51%,9453,-6362,6%,85-86,85-86 Dallas Mavericks,5.43902439,83.02439024,88.46341463
1986,1985-86,Portland Trail Blazers,82,19855,3610,7281,50%,74,275,27%,3536,7006,51%,9436,-6731,4%,85-86,85-86 Portland Trail Blazers,3.353658537,85.43902439,88.79268293
1986,1985-86,Denver Nuggets,82,19755,3705,7868,47%,71,305,23%,3634,7563,48%,9410,-7258,4%,85-86,85-86 Denver Nuggets,3.719512195,92.23170732,95.95121951
1986,1985-86,Milwaukee Bucks,82,19805,3601,7310,49%,125,382,33%,3476,6928,50%,9390,-6546,5%,85-86,85-86 Milwaukee Bucks,4.658536585,84.48780488,89.14634146
1986,1985-86,Houston Rockets,82,19755,3759,7671,49%,85,310,27%,3674,7361,50%,9379,-7051,4%,85-86,85-86 Houston Rockets,3.780487805,89.76829268,93.54878049
1986,1985-86,Detroit Pistons,82,19780,3754,7750,48%,55,182,30%,3699,7568,49%,9363,-7386,2%,85-86,85-86 Detroit Pistons,2.219512195,92.29268293,94.51219512
1986,1985-86,Boston Celtics,82,19855,3718,7312,51%,138,393,35%,3580,6919,52%,9359,-6526,5%,85-86,85-86 Boston Celtics,4.792682927,84.37804878,89.17073171
1986,1985-86,Golden State Warriors,82,19780,3650,7567,48%,87,278,31%,3563,7289,49%,9299,-7011,4%,85-86,85-86 Golden State Warriors,3.390243902,88.8902439,92.2804878
1986,1985-86,San Antonio Spurs,82,19805,3596,7104,51%,46,196,24%,3550,6908,51%,9120,-6712,3%,85-86,85-86 San Antonio Spurs,2.390243902,84.24390244,86.63414634
1986,1985-86,Philadelphia 76ers,82,19905,3435,7058,49%,51,224,23%,3384,6834,50%,9051,-6610,3%,85-86,85-86 Philadelphia 76ers,2.731707317,83.34146341,86.07317073
1986,1985-86,Phoenix Suns,82,19805,3518,6993,50%,38,183,21%,3480,6810,51%,9023,-6627,3%,85-86,85-86 Phoenix Suns,2.231707317,83.04878049,85.2804878
1986,1985-86,Chicago Bulls,82,19855,3476,7227,48%,88,317,28%,3388,6910,49%,8962,-6593,4%,85-86,85-86 Chicago Bulls,3.865853659,84.26829268,88.13414634
1986,1985-86,New Jersey Nets,82,19805,3548,7301,49%,43,214,20%,3505,7087,50%,8949,-6873,3%,85-86,85-86 New Jersey Nets,2.609756098,86.42682927,89.03658537
1986,1985-86,Sacramento Kings,82,19780,3538,7220,49%,30,134,22%,3508,7086,50%,8924,-6952,2%,85-86,85-86 Sacramento Kings,1.634146341,86.41463415,88.04878049
1986,1985-86,Los Angeles Clippers,82,19755,3388,7165,47%,64,229,28%,3324,6936,48%,8907,-6707,3%,85-86,85-86 Los Angeles Clippers,2.792682927,84.58536585,87.37804878
1986,1985-86,Atlanta Hawks,82,19805,3447,7029,49%,33,166,20%,3414,6863,50%,8906,-6697,2%,85-86,85-86 Atlanta Hawks,2.024390244,83.69512195,85.7195122
1986,1985-86,Utah Jazz,82,19780,3453,7083,49%,35,169,21%,3418,6914,49%,8871,-6745,2%,85-86,85-86 Utah Jazz,2.06097561,84.31707317,86.37804878
1986,1985-86,Cleveland Cavaliers,82,19780,3478,7239,48%,132,391,34%,3346,6848,49%,8836,-6457,5%,85-86,85-86 Cleveland Cavaliers,4.768292683,83.51219512,88.2804878
1986,1985-86,Seattle SuperSonics,82,19930,3335,7059,47%,79,300,26%,3256,6759,48%,8564,-6459,4%,85-86,85-86 Seattle SuperSonics,3.658536585,82.42682927,86.08536585
1986,1985-86,Indiana Pacers,82,19755,3441,7150,48%,23,143,16%,3418,7007,49%,8519,-6864,2%,85-86,85-86 Indiana Pacers,1.743902439,85.45121951,87.19512195
1986,1985-86,Washington Bullets,82,19855,3311,7148,46%,116,408,28%,3195,6740,47%,8442,-6332,6%,85-86,85-86 Washington Bullets,4.975609756,82.19512195,87.17073171
1986,1985-86,New York Knicks,82,19805,3239,7034,46%,82,239,34%,3157,6795,47%,8094,-6556,3%,85-86,85-86 New York Knicks,2.914634146,82.86585366,85.7804878
1985,1984-85,Denver Nuggets,82,19830,3876,7976,49%,73,235,31%,3803,7741,49%,9841,-7506,3%,84-85,84-85 Denver Nuggets,2.865853659,94.40243902,97.26829268
1985,1984-85,Los Angeles Lakers,82,19755,3952,7254,55%,90,295,31%,3862,6959,56%,9696,-6664,4%,84-85,84-85 Los Angeles Lakers,3.597560976,84.86585366,88.46341463
1985,1984-85,Detroit Pistons,82,19830,3840,7999,48%,45,199,23%,3795,7800,49%,9508,-7601,2%,84-85,84-85 Detroit Pistons,2.426829268,95.12195122,97.54878049
1985,1984-85,Portland Trail Blazers,82,19880,3708,7374,50%,51,202,25%,3657,7172,51%,9469,-6970,3%,84-85,84-85 Portland Trail Blazers,2.463414634,87.46341463,89.92682927
1985,1984-85,Kansas City Kings,82,19755,3664,7275,50%,63,238,27%,3601,7037,51%,9413,-6799,3%,84-85,84-85 Kansas City Kings,2.902439024,85.81707317,88.7195122
1985,1984-85,Boston Celtics,82,19705,3721,7325,51%,110,309,36%,3611,7016,52%,9412,-6707,4%,84-85,84-85 Boston Celtics,3.768292683,85.56097561,89.32926829
1985,1984-85,San Antonio Spurs,82,19780,3698,7202,51%,55,202,27%,3643,7000,52%,9412,-6798,3%,84-85,84-85 San Antonio Spurs,2.463414634,85.36585366,87.82926829
1985,1984-85,Philadelphia 76ers,82,19805,3443,6992,49%,59,224,26%,3384,6768,50%,9261,-6544,3%,84-85,84-85 Philadelphia 76ers,2.731707317,82.53658537,85.26829268
1985,1984-85,Houston Rockets,82,19830,3748,7440,50%,41,186,22%,3707,7254,51%,9118,-7068,3%,84-85,84-85 Houston Rockets,2.268292683,88.46341463,90.73170732
1985,1984-85,Dallas Mavericks,82,19855,3560,7280,49%,152,443,34%,3408,6837,50%,9116,-6394,6%,84-85,84-85 Dallas Mavericks,5.402439024,83.37804878,88.7804878
1985,1984-85,Milwaukee Bucks,82,19805,3564,7256,49%,89,294,30%,3475,6962,50%,9090,-6668,4%,84-85,84-85 Milwaukee Bucks,3.585365854,84.90243902,88.48780488
1985,1984-85,Golden State Warriors,82,19855,3498,7555,46%,112,397,28%,3386,7158,47%,9052,-6761,5%,84-85,84-85 Golden State Warriors,4.841463415,87.29268293,92.13414634
1985,1984-85,New Jersey Nets,82,19755,3646,7445,49%,52,224,23%,3594,7221,50%,8975,-6997,3%,84-85,84-85 New Jersey Nets,2.731707317,88.06097561,90.79268293
1985,1984-85,Utah Jazz,82,19755,3478,7302,48%,103,307,34%,3375,6995,48%,8937,-6688,4%,84-85,84-85 Utah Jazz,3.743902439,85.30487805,89.04878049
1985,1984-85,Chicago Bulls,82,19805,3453,6909,50%,29,161,18%,3424,6748,51%,8916,-6587,2%,84-85,84-85 Chicago Bulls,1.963414634,82.29268293,84.25609756
1985,1984-85,Cleveland Cavaliers,82,19780,3470,7364,47%,96,335,29%,3374,7029,48%,8903,-6694,5%,84-85,84-85 Cleveland Cavaliers,4.085365854,85.7195122,89.80487805
1985,1984-85,Indiana Pacers,82,19780,3489,7324,48%,30,155,19%,3459,7169,48%,8879,-7014,2%,84-85,84-85 Indiana Pacers,1.890243902,87.42682927,89.31707317
1985,1984-85,Phoenix Suns,82,19805,3507,7144,49%,87,307,28%,3420,6837,50%,8858,-6530,4%,84-85,84-85 Phoenix Suns,3.743902439,83.37804878,87.12195122
1985,1984-85,Los Angeles Clippers,82,19730,3527,7119,50%,56,188,30%,3471,6931,50%,8784,-6743,3%,84-85,84-85 Los Angeles Clippers,2.292682927,84.52439024,86.81707317
1985,1984-85,Atlanta Hawks,82,19855,3444,7119,48%,73,235,31%,3371,6884,49%,8743,-6649,3%,84-85,84-85 Atlanta Hawks,2.865853659,83.95121951,86.81707317
1985,1984-85,Washington Bullets,82,19855,3534,7383,48%,109,398,27%,3425,6985,49%,8655,-6587,5%,84-85,84-85 Washington Bullets,4.853658537,85.18292683,90.03658537
1985,1984-85,New York Knicks,82,19830,3435,7101,48%,51,198,26%,3384,6903,49%,8627,-6705,3%,84-85,84-85 New York Knicks,2.414634146,84.18292683,86.59756098
1985,1984-85,Seattle SuperSonics,82,19705,3277,6910,47%,45,185,24%,3232,6725,48%,8376,-6540,3%,84-85,84-85 Seattle SuperSonics,2.256097561,82.01219512,84.26829268
1984,1983-84,Denver Nuggets,82,19805,3935,7983,49%,77,255,30%,3858,7728,50%,10147,-7473,3%,83-84,83-84 Denver Nuggets,3.109756098,94.24390244,97.35365854
1984,1983-84,San Antonio Spurs,82,19980,3909,7721,51%,79,263,30%,3830,7458,51%,9862,-7195,3%,83-84,83-84 San Antonio Spurs,3.207317073,90.95121951,94.15853659
1984,1983-84,Detroit Pistons,82,19905,3798,7910,48%,32,141,23%,3766,7769,49%,9602,-7628,2%,83-84,83-84 Detroit Pistons,1.719512195,94.74390244,96.46341463
1984,1983-84,Los Angeles Lakers,82,19780,3854,7250,53%,58,226,26%,3796,7024,54%,9478,-6798,3%,83-84,83-84 Los Angeles Lakers,2.756097561,85.65853659,88.41463415
1984,1983-84,Utah Jazz,82,19780,3606,7242,50%,101,317,32%,3505,6925,51%,9428,-6608,4%,83-84,83-84 Utah Jazz,3.865853659,84.45121951,88.31707317
1984,1983-84,Portland Trail Blazers,82,19805,3632,7189,51%,25,129,19%,3607,7060,51%,9277,-6931,2%,83-84,83-84 Portland Trail Blazers,1.573170732,86.09756098,87.67073171
1984,1983-84,Boston Celtics,82,19955,3616,7235,50%,55,229,24%,3561,7006,51%,9194,-6777,3%,83-84,83-84 Boston Celtics,2.792682927,85.43902439,88.23170732
1984,1983-84,Phoenix Suns,82,19780,3677,7220,51%,74,291,25%,3603,6929,52%,9101,-6638,4%,83-84,83-84 Phoenix Suns,3.548780488,84.5,88.04878049
1984,1983-84,San Diego Clippers,82,19730,3634,7325,50%,24,128,19%,3610,7197,50%,9077,-7069,2%,83-84,83-84 San Diego Clippers,1.56097561,87.76829268,89.32926829
1984,1983-84,Houston Rockets,82,19755,3729,7533,50%,30,154,20%,3699,7379,50%,9071,-7225,2%,83-84,83-84 Houston Rockets,1.87804878,89.98780488,91.86585366
1984,1983-84,Dallas Mavericks,82,19955,3618,7235,50%,42,184,23%,3576,7051,51%,9052,-6867,3%,83-84,83-84 Dallas Mavericks,2.243902439,85.98780488,88.23170732
1984,1983-84,Kansas City Kings,82,19755,3516,7230,49%,52,189,28%,3464,7041,49%,9023,-6852,3%,83-84,83-84 Kansas City Kings,2.304878049,85.86585366,88.17073171
1984,1983-84,New Jersey Nets,82,19805,3614,7258,50%,49,232,21%,3565,7026,51%,9019,-6794,3%,83-84,83-84 New Jersey Nets,2.829268293,85.68292683,88.51219512
1984,1983-84,Golden State Warriors,82,19830,3519,7534,47%,55,226,24%,3464,7308,47%,9008,-7082,3%,83-84,83-84 Golden State Warriors,2.756097561,89.12195122,91.87804878
1984,1983-84,Seattle SuperSonics,82,19780,3460,7083,49%,27,140,19%,3433,6943,49%,8865,-6803,2%,83-84,83-84 Seattle SuperSonics,1.707317073,84.67073171,86.37804878
1984,1983-84,Philadelphia 76ers,82,19955,3384,6833,50%,29,107,27%,3355,6726,50%,8838,-6619,2%,83-84,83-84 Philadelphia 76ers,1.304878049,82.02439024,83.32926829
1984,1983-84,New York Knicks,82,19855,3386,6837,50%,47,165,29%,3339,6672,50%,8763,-6507,2%,83-84,83-84 New York Knicks,2.012195122,81.36585366,83.37804878
1984,1983-84,Milwaukee Bucks,82,19905,3432,6970,49%,59,232,25%,3373,6738,50%,8666,-6506,3%,83-84,83-84 Milwaukee Bucks,2.829268293,82.17073171,85
1984,1983-84,Indiana Pacers,82,19780,3447,7130,48%,48,207,23%,3399,6923,49%,8566,-6716,3%,83-84,83-84 Indiana Pacers,2.524390244,84.42682927,86.95121951
1984,1983-84,Chicago Bulls,82,19980,3305,6972,47%,20,117,17%,3285,6855,48%,8501,-6738,2%,83-84,83-84 Chicago Bulls,1.426829268,83.59756098,85.02439024
1984,1983-84,Washington Bullets,82,19905,3344,6907,48%,71,282,25%,3273,6625,49%,8423,-6343,4%,83-84,83-84 Washington Bullets,3.43902439,80.79268293,84.23170732
1984,1983-84,Cleveland Cavaliers,82,19855,3362,7232,47%,43,164,26%,3319,7068,47%,8386,-6904,2%,83-84,83-84 Cleveland Cavaliers,2,86.19512195,88.19512195
1984,1983-84,Atlanta Hawks,82,19855,3230,6809,47%,23,106,22%,3207,6703,48%,8321,-6597,2%,83-84,83-84 Atlanta Hawks,1.292682927,81.74390244,83.03658537
1983,1982-83,Denver Nuggets,82,19730,3951,7999,49%,24,126,19%,3927,7873,50%,10105,-7747,2%,82-83,82-83 Denver Nuggets,1.536585366,96.01219512,97.54878049
1983,1982-83,Los Angeles Lakers,82,19730,3964,7512,53%,10,96,10%,3954,7416,53%,9433,-7320,1%,82-83,82-83 Los Angeles Lakers,1.170731707,90.43902439,91.6097561
1983,1982-83,San Antonio Spurs,82,19780,3697,7340,50%,94,308,31%,3603,7032,51%,9375,-6724,4%,82-83,82-83 San Antonio Spurs,3.756097561,85.75609756,89.51219512
1983,1982-83,Kansas City Kings,82,19780,3719,7485,50%,51,215,24%,3668,7270,51%,9328,-7055,3%,82-83,82-83 Kansas City Kings,2.62195122,88.65853659,91.2804878
1983,1982-83,Dallas Mavericks,82,19730,3674,7550,49%,43,185,23%,3631,7365,49%,9243,-7180,2%,82-83,82-83 Dallas Mavericks,2.256097561,89.81707317,92.07317073
1983,1982-83,Detroit Pistons,82,19880,3623,7602,48%,72,272,27%,3551,7330,48%,9239,-7058,4%,82-83,82-83 Detroit Pistons,3.317073171,89.3902439,92.70731707
1983,1982-83,Boston Celtics,82,19830,3711,7547,49%,39,186,21%,3672,7361,50%,9191,-7175,2%,82-83,82-83 Boston Celtics,2.268292683,89.76829268,92.03658537
1983,1982-83,Philadelphia 76ers,82,19830,3600,7212,50%,25,109,23%,3575,7103,50%,9191,-6994,2%,82-83,82-83 Philadelphia 76ers,1.329268293,86.62195122,87.95121951
1983,1982-83,Chicago Bulls,82,19905,3537,7373,48%,45,209,22%,3492,7164,49%,9102,-6955,3%,82-83,82-83 Chicago Bulls,2.548780488,87.36585366,89.91463415
1983,1982-83,Seattle SuperSonics,82,19805,3597,7277,49%,29,138,21%,3568,7139,50%,9019,-7001,2%,82-83,82-83 Seattle SuperSonics,1.682926829,87.06097561,88.74390244
1983,1982-83,Utah Jazz,82,19755,3525,7342,48%,44,183,24%,3481,7159,49%,8938,-6976,2%,82-83,82-83 Utah Jazz,2.231707317,87.30487805,89.53658537
1983,1982-83,Indiana Pacers,82,19830,3707,7723,48%,50,236,21%,3657,7487,49%,8911,-7251,3%,82-83,82-83 Indiana Pacers,2.87804878,91.30487805,94.18292683
1983,1982-83,Golden State Warriors,82,19780,3627,7508,48%,34,150,23%,3593,7358,49%,8908,-7208,2%,82-83,82-83 Golden State Warriors,1.829268293,89.73170732,91.56097561
1983,1982-83,San Diego Clippers,82,19830,3625,7634,48%,64,262,24%,3561,7372,48%,8903,-7110,3%,82-83,82-83 San Diego Clippers,3.195121951,89.90243902,93.09756098
1983,1982-83,Portland Trail Blazers,82,19755,3459,7124,49%,35,150,23%,3424,6974,49%,8808,-6824,2%,82-83,82-83 Portland Trail Blazers,1.829268293,85.04878049,86.87804878
1983,1982-83,Phoenix Suns,82,19730,3555,7158,50%,40,158,25%,3515,7000,50%,8776,-6842,2%,82-83,82-83 Phoenix Suns,1.926829268,85.36585366,87.29268293
1983,1982-83,Milwaukee Bucks,82,19830,3486,7133,49%,37,169,22%,3449,6964,50%,8740,-6795,2%,82-83,82-83 Milwaukee Bucks,2.06097561,84.92682927,86.98780488
1983,1982-83,New Jersey Nets,82,19705,3510,7140,49%,30,149,20%,3480,6991,50%,8672,-6842,2%,82-83,82-83 New Jersey Nets,1.817073171,85.25609756,87.07317073
1983,1982-83,Atlanta Hawks,82,19780,3352,7146,47%,45,188,24%,3307,6958,48%,8335,-6770,3%,82-83,82-83 Atlanta Hawks,2.292682927,84.85365854,87.14634146
1983,1982-83,New York Knicks,82,19805,3272,6793,48%,33,131,25%,3239,6662,49%,8198,-6531,2%,82-83,82-83 New York Knicks,1.597560976,81.24390244,82.84146341
1983,1982-83,Houston Rockets,82,19730,3338,7446,45%,67,271,25%,3271,7175,46%,8145,-6904,4%,82-83,82-83 Houston Rockets,3.304878049,87.5,90.80487805
1983,1982-83,Washington Bullets,82,19805,3306,7059,47%,70,237,30%,3236,6822,47%,8134,-6585,3%,82-83,82-83 Washington Bullets,2.890243902,83.19512195,86.08536585
1983,1982-83,Cleveland Cavaliers,82,19755,3252,6995,47%,30,120,25%,3222,6875,47%,7964,-6755,2%,82-83,82-83 Cleveland Cavaliers,1.463414634,83.84146341,85.30487805
1982,1981-82,Denver Nuggets,82,19830,3980,7656,52%,40,149,27%,3940,7507,53%,10371,-7358,2%,81-82,81-82 Denver Nuggets,1.817073171,91.54878049,93.36585366
1982,1981-82,Los Angeles Lakers,82,19855,3919,7585,52%,13,94,14%,3906,7491,52%,9400,-7397,1%,81-82,81-82 Los Angeles Lakers,1.146341463,91.35365854,92.5
1982,1981-82,San Antonio Spurs,82,19755,3698,7613,49%,64,252,25%,3634,7361,49%,9272,-7109,3%,81-82,81-82 San Antonio Spurs,3.073170732,89.76829268,92.84146341
1982,1981-82,Boston Celtics,82,19780,3657,7334,50%,49,184,27%,3608,7150,51%,9180,-6966,3%,81-82,81-82 Boston Celtics,2.243902439,87.19512195,89.43902439
1982,1981-82,Philadelphia 76ers,82,19855,3616,6974,52%,41,139,30%,3575,6835,52%,9119,-6696,2%,81-82,81-82 Philadelphia 76ers,1.695121951,83.35365854,85.04878049
1982,1981-82,Detroit Pistons,82,19830,3561,7391,48%,52,213,24%,3509,7178,49%,9112,-6965,3%,81-82,81-82 Detroit Pistons,2.597560976,87.53658537,90.13414634
1982,1981-82,Utah Jazz,82,19780,3679,7446,49%,22,97,23%,3657,7349,50%,9094,-7252,1%,81-82,81-82 Utah Jazz,1.182926829,89.62195122,90.80487805
1982,1981-82,Golden State Warriors,82,19780,3646,7349,50%,91,325,28%,3555,7024,51%,9092,-6699,4%,81-82,81-82 Golden State Warriors,3.963414634,85.65853659,89.62195122
1982,1981-82,Portland Trail Blazers,82,19780,3629,7187,51%,29,140,21%,3600,7047,51%,9006,-6907,2%,81-82,81-82 Portland Trail Blazers,1.707317073,85.93902439,87.64634146
1982,1981-82,San Diego Clippers,82,19755,3552,7101,50%,99,338,29%,3453,6763,51%,8896,-6425,5%,81-82,81-82 San Diego Clippers,4.12195122,82.47560976,86.59756098
1982,1981-82,Milwaukee Bucks,82,19805,3544,7015,51%,49,164,30%,3495,6851,51%,8890,-6687,2%,81-82,81-82 Milwaukee Bucks,2,83.54878049,85.54878049
1982,1981-82,Seattle SuperSonics,82,19830,3505,7178,49%,38,153,25%,3467,7025,49%,8795,-6872,2%,81-82,81-82 Seattle SuperSonics,1.865853659,85.67073171,87.53658537
1982,1981-82,Kansas City Kings,82,19880,3604,7284,50%,26,130,20%,3578,7154,50%,8785,-7024,2%,81-82,81-82 Kansas City Kings,1.585365854,87.24390244,88.82926829
1982,1981-82,New Jersey Nets,82,19780,3501,7227,48%,30,146,21%,3471,7081,49%,8746,-6935,2%,81-82,81-82 New Jersey Nets,1.780487805,86.35365854,88.13414634
1982,1981-82,Chicago Bulls,82,19880,3369,6728,50%,54,213,25%,3315,6515,51%,8743,-6302,3%,81-82,81-82 Chicago Bulls,2.597560976,79.45121951,82.04878049
1982,1981-82,New York Knicks,82,19830,3523,7178,49%,58,214,27%,3465,6964,50%,8707,-6750,3%,81-82,81-82 New York Knicks,2.609756098,84.92682927,87.53658537
1982,1981-82,Phoenix Suns,82,19830,3508,7140,49%,54,174,31%,3454,6966,50%,8705,-6792,2%,81-82,81-82 Phoenix Suns,2.12195122,84.95121951,87.07317073
1982,1981-82,Houston Rockets,82,19780,3504,7366,48%,50,176,28%,3454,7190,48%,8680,-7014,2%,81-82,81-82 Houston Rockets,2.146341463,87.68292683,89.82926829
1982,1981-82,Dallas Mavericks,82,19730,3390,7224,47%,55,190,29%,3335,7034,47%,8575,-6844,3%,81-82,81-82 Dallas Mavericks,2.317073171,85.7804878,88.09756098
1982,1981-82,Washington Bullets,82,19830,3400,7168,47%,59,236,25%,3341,6932,48%,8485,-6696,3%,81-82,81-82 Washington Bullets,2.87804878,84.53658537,87.41463415
1982,1981-82,Cleveland Cavaliers,82,19805,3405,7334,46%,25,137,18%,3380,7197,47%,8463,-7060,2%,81-82,81-82 Cleveland Cavaliers,1.670731707,87.76829268,89.43902439
1982,1981-82,Indiana Pacers,82,19830,3332,7164,47%,103,316,33%,3229,6848,47%,8379,-6532,4%,81-82,81-82 Indiana Pacers,3.853658537,83.51219512,87.36585366
1982,1981-82,Atlanta Hawks,82,19880,3210,6776,47%,28,128,22%,3182,6648,48%,8281,-6520,2%,81-82,81-82 Atlanta Hawks,1.56097561,81.07317073,82.63414634
1981,1980-81,Denver Nuggets,82,19955,3784,7960,48%,30,145,21%,3754,7815,48%,9986,-7670,2%,80-81,80-81 Denver Nuggets,1.768292683,95.30487805,97.07317073
1981,1980-81,Milwaukee Bucks,82,19755,3722,7472,50%,30,131,23%,3692,7341,50%,9276,-7210,2%,80-81,80-81 Milwaukee Bucks,1.597560976,89.52439024,91.12195122
1981,1980-81,San Antonio Spurs,82,19805,3571,7276,49%,15,85,18%,3556,7191,50%,9209,-7106,1%,80-81,80-81 San Antonio Spurs,1.036585366,87.69512195,88.73170732
1981,1980-81,Philadelphia 76ers,82,19855,3636,7073,51%,19,84,23%,3617,6989,52%,9156,-6905,1%,80-81,80-81 Philadelphia 76ers,1.024390244,85.23170732,86.25609756
1981,1980-81,Los Angeles Lakers,82,19805,3780,7382,51%,17,94,18%,3763,7288,52%,9117,-7194,1%,80-81,80-81 Los Angeles Lakers,1.146341463,88.87804878,90.02439024
1981,1980-81,Portland Trail Blazers,82,19855,3741,7535,50%,25,148,17%,3716,7387,50%,9080,-7239,2%,80-81,80-81 Portland Trail Blazers,1.804878049,90.08536585,91.8902439
1981,1980-81,Phoenix Suns,82,19755,3587,7326,49%,35,161,22%,3552,7165,50%,9019,-7004,2%,80-81,80-81 Phoenix Suns,1.963414634,87.37804878,89.34146341
1981,1980-81,Boston Celtics,82,19780,3581,7099,50%,65,241,27%,3516,6858,51%,9008,-6617,3%,80-81,80-81 Boston Celtics,2.93902439,83.63414634,86.57317073
1981,1980-81,Golden State Warriors,82,19730,3560,7284,49%,60,210,29%,3500,7074,50%,9006,-6864,3%,80-81,80-81 Golden State Warriors,2.56097561,86.26829268,88.82926829
1981,1980-81,Chicago Bulls,82,19780,3457,6903,50%,38,179,21%,3419,6724,51%,8937,-6545,3%,80-81,80-81 Chicago Bulls,2.182926829,82,84.18292683
1981,1980-81,Houston Rockets,82,19805,3573,7335,49%,21,118,18%,3552,7217,49%,8878,-7099,2%,80-81,80-81 Houston Rockets,1.43902439,88.01219512,89.45121951
1981,1980-81,New York Knicks,82,19830,3505,7255,48%,56,236,24%,3449,7019,49%,8849,-6783,3%,80-81,80-81 New York Knicks,2.87804878,85.59756098,88.47560976
1981,1980-81,Indiana Pacers,82,19730,3491,7245,48%,30,169,18%,3461,7076,49%,8827,-6907,2%,80-81,80-81 Indiana Pacers,2.06097561,86.29268293,88.35365854
1981,1980-81,Kansas City Kings,82,19830,3572,7151,50%,49,168,29%,3523,6983,51%,8769,-6815,2%,80-81,80-81 Kansas City Kings,2.048780488,85.15853659,87.20731707
1981,1980-81,New Jersey Nets,82,19805,3477,7314,48%,34,138,25%,3443,7176,48%,8768,-7038,2%,80-81,80-81 New Jersey Nets,1.682926829,87.51219512,89.19512195
1981,1980-81,San Diego Clippers,82,19730,3477,7283,48%,132,407,32%,3345,6876,49%,8737,-6469,6%,80-81,80-81 San Diego Clippers,4.963414634,83.85365854,88.81707317
1981,1980-81,Cleveland Cavaliers,82,19780,3556,7609,47%,72,249,29%,3484,7360,47%,8670,-7111,3%,80-81,80-81 Cleveland Cavaliers,3.036585366,89.75609756,92.79268293
1981,1980-81,Washington Bullets,82,19780,3549,7517,47%,65,241,27%,3484,7276,48%,8662,-7035,3%,80-81,80-81 Washington Bullets,2.93902439,88.73170732,91.67073171
1981,1980-81,Atlanta Hawks,82,19930,3291,6866,48%,10,82,12%,3281,6784,48%,8604,-6702,1%,80-81,80-81 Atlanta Hawks,1,82.73170732,83.73170732
1981,1980-81,Seattle SuperSonics,82,19780,3343,7145,47%,32,117,27%,3311,7028,47%,8531,-6911,2%,80-81,80-81 Seattle SuperSonics,1.426829268,85.70731707,87.13414634
1981,1980-81,Dallas Mavericks,82,19780,3204,6928,46%,46,165,28%,3158,6763,47%,8322,-6598,2%,80-81,80-81 Dallas Mavericks,2.012195122,82.47560976,84.48780488
1981,1980-81,Utah Jazz,82,19730,3332,6825,49%,42,163,26%,3290,6662,49%,8301,-6499,2%,80-81,80-81 Utah Jazz,1.987804878,81.24390244,83.23170732
1981,1980-81,Detroit Pistons,82,19755,3236,6986,46%,13,84,16%,3223,6902,47%,8174,-6818,1%,80-81,80-81 Detroit Pistons,1.024390244,84.17073171,85.19512195
1980,1979-80,San Antonio Spurs,82,19755,3856,7738,50%,52,206,25%,3804,7532,51%,9788,-7326,3%,79-80,79-80 San Antonio Spurs,2.512195122,91.85365854,94.36585366
1980,1979-80,Los Angeles Lakers,82,19880,3898,7368,53%,20,100,20%,3878,7268,53%,9438,-7168,1%,79-80,79-80 Los Angeles Lakers,1.219512195,88.63414634,89.85365854
1980,1979-80,Cleveland Cavaliers,82,19930,3811,8041,47%,36,187,19%,3775,7854,48%,9360,-7667,2%,79-80,79-80 Cleveland Cavaliers,2.280487805,95.7804878,98.06097561
1980,1979-80,New York Knicks,82,19780,3802,7672,50%,42,191,22%,3760,7481,50%,9344,-7290,2%,79-80,79-80 New York Knicks,2.329268293,91.23170732,93.56097561
1980,1979-80,Boston Celtics,82,19880,3617,7387,49%,162,422,38%,3455,6965,50%,9303,-6543,6%,79-80,79-80 Boston Celtics,5.146341463,84.93902439,90.08536585
1980,1979-80,Indiana Pacers,82,19855,3639,7689,47%,88,314,28%,3551,7375,48%,9119,-7061,4%,79-80,79-80 Indiana Pacers,3.829268293,89.93902439,93.76829268
1980,1979-80,Phoenix Suns,82,19755,3570,7235,49%,68,280,24%,3502,6955,50%,9114,-6675,4%,79-80,79-80 Phoenix Suns,3.414634146,84.81707317,88.23170732
1980,1979-80,Houston Rockets,82,19930,3599,7496,48%,104,379,27%,3495,7117,49%,9084,-6738,5%,79-80,79-80 Houston Rockets,4.62195122,86.79268293,91.41463415
1980,1979-80,Milwaukee Bucks,82,19805,3685,7553,49%,50,155,32%,3635,7398,49%,9025,-7243,2%,79-80,79-80 Milwaukee Bucks,1.890243902,90.2195122,92.1097561
1980,1979-80,Philadelphia 76ers,82,19855,3523,7156,49%,27,125,22%,3496,7031,50%,8949,-6906,2%,79-80,79-80 Philadelphia 76ers,1.524390244,85.74390244,87.26829268
1980,1979-80,Detroit Pistons,82,19780,3643,7596,48%,57,219,26%,3586,7377,49%,8933,-7158,3%,79-80,79-80 Detroit Pistons,2.670731707,89.96341463,92.63414634
1980,1979-80,Seattle SuperSonics,82,19830,3554,7565,47%,59,189,31%,3495,7376,47%,8897,-7187,2%,79-80,79-80 Seattle SuperSonics,2.304878049,89.95121951,92.25609756
1980,1979-80,New Jersey Nets,82,19805,3456,7504,46%,85,298,29%,3371,7206,47%,8879,-6908,4%,79-80,79-80 New Jersey Nets,3.634146341,87.87804878,91.51219512
1980,1979-80,Denver Nuggets,82,19830,3462,7470,46%,83,255,33%,3379,7215,47%,8878,-6960,3%,79-80,79-80 Denver Nuggets,3.109756098,87.98780488,91.09756098
1980,1979-80,Kansas City Kings,82,19805,3582,7489,48%,25,114,22%,3557,7375,48%,8860,-7261,2%,79-80,79-80 Kansas City Kings,1.390243902,89.93902439,91.32926829
1980,1979-80,San Diego Clippers,82,19755,3524,7494,47%,177,543,33%,3347,6951,48%,8820,-6408,7%,79-80,79-80 San Diego Clippers,6.62195122,84.76829268,91.3902439
1980,1979-80,Chicago Bulls,82,19905,3362,6943,48%,70,275,26%,3292,6668,49%,8813,-6393,4%,79-80,79-80 Chicago Bulls,3.353658537,81.31707317,84.67073171
1980,1979-80,Washington Bullets,82,19880,3574,7796,46%,73,238,31%,3501,7558,46%,8773,-7320,3%,79-80,79-80 Washington Bullets,2.902439024,92.17073171,95.07317073
1980,1979-80,Atlanta Hawks,82,19780,3261,7027,46%,13,75,17%,3248,6952,47%,8573,-6877,1%,79-80,79-80 Atlanta Hawks,0.914634146,84.7804878,85.69512195
1980,1979-80,Golden State Warriors,82,19880,3527,7318,48%,27,121,22%,3500,7197,49%,8493,-7076,2%,79-80,79-80 Golden State Warriors,1.475609756,87.76829268,89.24390244
1980,1979-80,Portland Trail Blazers,82,19780,3408,7167,48%,26,132,20%,3382,7035,48%,8402,-6903,2%,79-80,79-80 Portland Trail Blazers,1.609756098,85.79268293,87.40243902
1980,1979-80,Utah Jazz,82,19805,3382,6817,50%,59,185,32%,3323,6632,50%,8394,-6447,3%,79-80,79-80 Utah Jazz,2.256097561,80.87804878,83.13414634
